阿母为汝求	bxyf
阿母谢媒人	bxyw
阿那曲	bvma
阿若憍陈如	banv
蔼蔼帝王州	aauy
哀哀父母	yywx
蔼蔼树色深	aasi
暧暧远人村	jjfs
哀多如更闻	yqvu
爱而不见	edgm
哀而不伤	ydgw
哀公问曰	ywuj
爱国治民	elin
爱酒不愧天	eigg
爱君得自遂	evtu
哀鸣嗷嗷	ykkk
欸乃曲	cema
爱神仙	epwm
爱他明月好	ewjv
哀王孙	ygbi
哀吾生之须臾	ygtv
爱以身为天下	entg
哀怨起骚人	yqfw
哀乐不能入也	yqgb
哀哉王孙慎勿疏	yfgn
爱之欲其生	epwt
爱竹最知王子猷	etju
暗暗淡淡紫	jjih
黯黯见临洮	llmi
安禅制毒龙	pprd
暗尘随马去	jibf
安得长苦悲	pttd
安得临仙坛	ptjf
安得上方断马剑	pthw
安得倚天抽宝剑	ptww
安得倚天剑	ptww
安得至老不更归	ptgj
安得壮士挽天河	ptui
安定城楼	ppfs
暗飞萤自照	jnaj
安凤	pvmc
暗风吹雨入寒窗	jmkp
安鸿渐	piil
岸花飞送客	manp
安乐公主	pqwy
安且吉兮	pefw
岸容待腊将舒柳	mpts
安上纯父	phxw
岸上蝴蝶飞	mhjn
岸上沙	mhii
安石东山三十春	pdad
安时而处顺	pjdk
安守范	ppai
暗水流花径	jiit
安危定变	pqpy
安危托妇人	pqrw
安危相易	pqsj
暗香疏影	jtnj
暗相思	jsln
安心是药更无方	pnjy
安阳好	pbvb
安在其不辱也	pdab
安知峰壑今来变	ptmy
暗掷金钱卜远人	jrqw
安知千里外	pttq
安知鱼之乐	ptqq
卬须我友	qetd
傲吏身闲笑五侯	wgtw
傲世似未敬	wawa
翱翔蓬蒿之间	ruau
八哀诗	wyyf
八宝妆	wpuv
八庚	wtyv
罢归无旧业	ljfo
把剑觅徐君	rwev
拔剑起蒿莱	rwfa
拔剑撞而破之	rwrp
芭蕉叶大栀子肥	aake
芭蕉雨	aafg
八节同欢	wamc
把酒话桑麻	riyy
把酒酹滔滔	risi
把酒留君听琴	riqg
把酒问天	riug
八骏日行三万里	wcjj
灞陵伤别	ibwk
巴陵无限酒	cbfi
巴陵一望洞庭秋	cbgt
八年七旱	wraj
八拍蛮	wryo
八齐	wtyj
八千岁为秋	wtmt
巴人讼芋田	cwyl
把汝裁为三截	riff
罢如江海凝清光	lvii
八塞	wtpf
八上	wthh
灞上秋居	ihtn
灞水流浩浩	iiii
巴水流若兹	ciiu
八岁偷照镜	wmwq
巴谈	cnyo
八万四千人	wdlw
八佾第三	wwtd
把意念沉潜得下	ruwg
八佾舞于庭	wwry
八音谐	wuyx
巴渝辞	citd
灞原风雨定	idmp
八月剥枣	wevg
八月洞庭秋	weit
八月蝴蝶来	wejg
八月十八潮	wefi
八月十五夜	wefy
八月萧关道	weau
八月在宇	wedp
八阵图	wblt
白波九道流雪山	rivm
百步九折萦岩峦	dhvy
百草竞春华	dauw
拜臣郎中	rayk
百尺楼	dnso
百尺楼高水接天	dnsg
百川灌河	dkii
白帝城边古木疏	rufn
白帝城高急暮砧	rufd
白帝城头月向西	rufs
白帝城下雨翻盆	rufw
白帝城中云出门	rufu
白帝高为三峡镇	ruyq
百堵皆作	dfxw
拜而受之	rdep
百尔所思	dqrl
百发百中无虚弦	dndx
白发悲花落	rnda
白发催年老	rnwf
白发自然生	rntt
百夫之特	dfpt
百舸争流	dtqi
白鸽子	rwbb
白骨乱蓬蒿	rmta
百官之富	dppp
白鹤子	rpbb
百花迹已绝	dayx
百花如旧日	davj
百花潭水即沧浪	daii
白花垣上望京师	rafj
白君瑞	rvgm
白狼河北音书断	rqio
白浪茫茫与海连	rial
白浪滔天	riig
百牢关	dpud
百里见秋毫	djmy
百里闻雷震	djuf
百里榆堤半日风	djsm
百两御之	dgtp
白露含明月	rfwe
白鹭下秋水	rkgi
白马出城中	rcbk
败马号鸣向天悲	mckd
白马嚼啮黄金勒	rcka
白茅包之	raqp
白茅纯束	raxg
百媚娘	dvvy
白门寥落意多违	rupf
白敏中	rtkh
百亩之田	dypl
百年长扰扰	drtr
百年都是几多时	drfj
百年歌自苦	drsa
百年老屋	drfn
百年离别在高楼	drys
百年魔怪舞翩跹	dryk
百年三万六千日	drdj
白鸟悠悠下	rqwg
白日不照吾精诚	rjgy
白日当天三月半	rjiu
白日登山望烽火	rjwo
白日何短短	rjwt
白日落梁州	rjay
白日暖	rjje
白日向西没	rjti
白石皓皓	rdrr
白石岩扉碧藓滋	rdmi
白首不相弃	rugy
拜手落花春	rrad
白首太玄经	rudx
白首忘机	ruys
白首卧松云	ruaf
白首相知犹按剑	rusw
白首一先生	rugt
白水明田外	rijq
白水暮东流	riai
白水真人居	rifn
白头吊古风霜里	rukj
白头宫女在	rupd
白兔捣药秋复春	rqrd
白团扇	rlyn
百万工农齐踊跃	ddak
百万雄师过大江	dddi
百万之师	ddpj
百物生焉	dttg
拜新月	ruee
拜星	rdjt
百姓不足	dvgk
百姓皆谓	dvxy
百姓有过	dvdf
拜星月	rjee
百姓之不见保	dvpw
白萱	rrap
白雪	rrfv
白雪词	rfyn
白雪关山远	rfuf
白雪梅花处处吹	rfsk
白雪难同调	rfcy
百宜娇	dpvt
拜迎官长心欲碎	rqpd
百有余年矣	ddwc
白玉不毁	rggv
白玉谁家郎	rgyy
白玉堂前一树梅	rgis
百越之君	dfpv
白云长在天	rftg
白云愁色满苍梧	rfts
白云处处长随君	rftv
白云还自散	rfga
白云回望合	rflw
白云千里万里	rftj
白云如有意	rfvu
白云山头云欲立	rfmu
白云山下呼声急	rfmq
白云生镜里	rftj
白云无尽时	rffj
白云依静渚	rfwi
白云映水摇空城	rfjf
白云在青天	rfdg
百战疲劳壮士哀	dhuy
百战沙场碎铁衣	dhiy
百丈山	ddmm
柏舟	srte
百字谣	dpye
百字字	dppb
半壁见海日	unmj
半留相送半迎归	uqsj
半落青天外	uagq
板桥晓别	ssjk
半洒云天里	uifj
伴云来	wfgo
斑竹一支千滴泪	gtgi
斑竹一枝千滴泪	gtgi
斑竹枝	gtsf
斑骓只系垂杨岸	gckm
半作障泥半作帆	uwbm
邦君之妻	dvpg
邦无道如矢	dfut
邦以民为本	dnns
邦有道如矢	ddut
邦有道则仕	dduw
抱布贸丝	rdqx
保持乐观	wrqc
保此道者	whuf
报答平生未展眉	rtgn
报道敌军宵遁	rutr
报到山中去	rgmf
报得三春辉	rtdi
鲍防	qgby
褒公鄂公毛发动	ywkf
抱关击柝	rufs
报国无成空白首	rlfu
包何	qnws
包贺	qnlk
暴虎冯河	jhui
包恢	qnnd
包佶	qnwf
宝剑直千金	pwfq
宝镜似空水	pqwi
包举宇内	qipm
鲍君徽	qvtm
暴君污吏	jvig
鲍老催	qfwm
鲍令晖	qwjp
抱明月而长终	rjex
抱琴看鹤去	rgrf
报任安书节选	rwpt
包融	qngk
鲍溶	qgip
宝扇迎归九华帐	pyqm
饱食终日	qwxj
褒姒灭之	yvgp
报孙会宗书	rbwn
暴殄天物圣所哀	jggy
报我不述	rtgs
包羞忍耻是男儿	quvq
包颖	qnxt
鸨羽	xfnn
褒之庐冢也	ypyb
报之以琼玖	rpng
报之以琼琚	rpng
北朝民歌	ufns
北狄愿和亲	uqdu
北斗兼春远	uuuf
北斗阑干南斗斜	uuuw
北斗七星高	uuay
北斗七星横夜半	uuau
北风北风	umum
北风吹白云	umkf
北风吹裙带	umkg
北风其凉	umau
背负青天朝下看	uqgr
背归鸿	ujia
北国风光	ulmi
北海若曰	uiaj
背后何所见	urwm
北极朝庭终不改	usfn
北京中华书局	uykn
悲来乎	dgtu
悲凉千里道	dutu
北流活活	uiii
北邙无数荒丘	uyfr
背面秋千下	udtg
杯盘狼籍	stqt
北齐二首	uyfu
北青萝	ugal
被驱不异犬与鸡	pcgc
北阙休上书	uuwn
背若泰山	uadm
北山白云里	umrj
北山移文	umty
北上太行山	uhdm
背世返能厌俗态	uard
北收要害之郡	unsv
北土非吾愿	ufdd
北杨柳	ussq
悲哉行	dftf
悲中乐	dkqi
奔波奚所营	diea
本长安倡女	stpv
本电子版	sjbt
本纪十二	sxff
本是池中物	sjit
奔腾急	deqv
本图宦达	slpd
本为贵公子	sykb
本性能耐寒	sncp
本以高难饱	snyq
本在于上	sdgh
本之则无	spmf
本自无教训	stfy
本自无人识	stfy
崩年亦在永安宫	mryp
迸泉飒飒飞木末	urug
迸水落遥空	uiap
必变色而作	nyqw
必表而出之	ngdp
必不得已而去	ngtf
彼采艾兮	teaw
彼采葛兮	teaw
彼采萧兮	teaw
彼苍者天	tafg
必朝服而朝	nfef
碧城三首	gfdu
碧城十二曲阑干	gfff
彼出于是	tbgj
碧窗梦	gpss
彼此甘心无后期	thaa
彼恶得而知之	tgtp
彼恶知之	tgtp
彼尔维何	tqxw
蔽芾甘棠	aaai
碧峰出山后	gmbr
比干谏而死	xfyg
必告父母	ntwx
敝笱	umtq
必故强之	ndxp
必故兴之	ndip
必故与之	ndgp
必故张之	ndxp
彼何人斯	twwa
碧荷生幽泉	gatr
必河之鲤	nipq
必积其德义	ntay
比及三年	xedr
彼稷之苗	ttpa
彼稷之实	ttpp
彼稷之穗	ttpt
彼狡童兮	tquw
必浚其泉源	niai
彼君子兮	tvbw
壁立千仞无依倚	nutw
鄙陋没世	kbia
彼路斯何	tkaw
鄙嫚不能萌	kvga
比梅	xxst
彼美孟姜	tubu
彼美人兮	tuww
闭门春尽杨花落	uuda
碧梦	grss
碧牡丹	gtmy
比目鱼	xhqg
比其反也	xarb
必齐如也	nyvb
彼其于世	taga
必齐之姜	nypu
彼其之子	tapb
必千乘之家	nttp
彼且恶乎待哉	tegf
彼窃钩者诛	tpqy
彼且奚适也	teeb
比权量力	xsjl
碧纱如烟隔窗语	gxvy
必世而后仁	nadw
必使反之	nwrp
彼是莫得其偶	tjaw
避世之人	napw
必熟而荐之	nydp
彼黍离离	ttyy
碧树银台万种色	gsqq
碧水浩浩云茫茫	giia
笔所未到气已吞	trfg
彼童子之师	tubj
必闻其政	nuag
碧文圆顶夜深缝	gylx
碧梧栖老凤凰枝	gsss
鼻息干虹蜺	ttfj
彼陷溺其民	tbin
碧虚	grha
毕耀	xxiq
彼尧舜之耿介兮	taew
必也狂狷乎	nbqt
必也临事而惧	nbjn
必也射乎	nbtt
必也圣乎	nbct
必也使无讼乎	nbwt
必以告妾	nntu
比翼共翱翔	xnau
必以身后之	nntp
彼亦是也	tyjb
必以言下之	nnyp
彼亦一是非	tygd
碧鹦鹉对红蔷薇	gmga
必有可观者焉	ndsg
必有明衣	ndjy
必有寝衣	ndpy
必有事焉而勿正	ndgg
必有我师	ndtj
必有凶年	ndqr
彼与彼年相若也	tgtb
比于赤子	xgfb
碧玉搔头落水中	ggrk
碧玉箫	ggtv
比予于毒	xcgg
彼于致福者	tggf
碧云深	gfip
彼泽之陂	tipb
笔阵独扫千人军	tbqp
必正席先尝之	ngyp
敝之而无憾	updn
必作于细	nwgx
必作于易	nwgj
边草尽来兵老	lanf
边草无穷日暮	lafa
边城路	lfkh
边城暮雨雁飞低	lfaw
遍地英雄下夕烟	yfao
变调如闻杨柳春	yyvd
笾豆之事	tgpg
变而有气	yddr
边风飘飘那可度	lmsy
汴河怀古	iind
汴河阻冻	iibu
辩乎荣辱之境	utaf
便即下阶拜	wvgr
便可白公姥	wsrv
便利此月内	wthm
遍历名山大川	ydqk
褊浅无所用	pife
遍绕篱边日渐斜	yxtw
边亭流血成海水	lyii
边庭流血成海水	lyii
边庭飘摇那可度	lysy
便言多令才	wyqf
便有精生白骨堆	wdof
便至四十西营田	wgll
便作旦夕间	wwju
变作呜咽声	ywkf
骠国乐	clqi
摽有梅	rdst
别房太尉墓	kyda
别君去时何时还	kvfg
别来沧海事	kgig
别离时节	kyja
别离在今晨	kydj
别路绕山川	kkxk
别梦依稀咒逝川	kswk
别时多	kjqq
别时茫茫江浸月	kjae
别树羁雌昨夜惊	ksln
别仙子	kwbb
别巷寂寥人散后	kapr
别徐州	ktyt
别样清幽	ksix
别有根芽	kdsa
别有天地非人间	kdgu
别怨	klqb
鬓边华	dlwx
宾不顾矣	pgdc
鬓发各已苍	dnta
鬓丝生几缕	dxtx
鬓云松	dfsw
兵残楚帐夜闻歌	rgss
兵车行	rltf
并蒂芙蓉	uaaa
兵法修列	riwg
兵革非不坚利也	radb
兵革既未息	ravt
秉国之钧	tlpq
冰肌玉骨清无汗	uegi
禀君子	yvbb
屏气似不息者	nrwf
冰轻叶未凋	ulku
兵刃既接	rvvr
冰山滴	umiu
病身坚固道情深	utji
病身最觉风露早	utjj
冰霜昨夜除	ufjb
并添高阁迥	uiym
并吞八荒之心	ugwn
兵卫森画戟	rbsf
病为兀兀安身物	uygt
冰崖转石万壑雷	umlf
兵者不祥之器	rfgk
并作南楼一味凉	uwfu
拨不断	rgon
薄乎云尔	atfq
薄宦梗犹泛	apsi
薄酒可与忘忧	aisn
波澜动远空	iifp
波澜誓不起	iirf
波澜相背惊	iisn
薄命女	awvv
薄暮空潭曲	aapm
薄暮渔樵乘水入	aait
伯牛有疾	wrdu
勃如战色	fvhq
波上马嘶看棹去	ihcf
伯氏吹埙	wqkf
薄苇纫如丝	aaxx
薄污我私	aitt
伯兮	wrwg
博学而无所成名	fidq
博学于文	figy
薄言采之	ayep
薄言掇之	ayrp
薄言捋之	ayrp
薄言有之	aydp
伯也执殳	wbrm
伯夷叔齐	wghy
伯禹亦不如	wtyv
泊岳阳城下	irbg
搏之不得	rpgt
伯仲之间见伊吕	wwpk
泊舟微径度深松	itts
不爱红装爱武装	gexu
不把双眉斗画长	grct
不保社稷	gwpt
不保四海	gwli
不保四体	gwlw
不必取长途	gnbw
不必问君平	gnug
不辩牛马	gurc
不辨仙源何处寻	guwv
不薄今人爱古人	gaww
步步娇	hhvt
不采而佩	gedw
不才明主弃	gfjy
不惭世上英	gnaa
步蟾宫	hjpk
不撤姜食	gruw
不称其服	gtae
不成人之恶	gdwg
不耻相师	gbsj
不愁明月尽	gtjn
步出城东门	hbfu
步出东斋读	hbay
不出三日	gbdj
不出三十年	gbdr
不辞山路远	gtmf
不待作年芳	gtwa
不到长城非好汉	ggti
不道引而寿	guxd
不道早已	gujn
不道之道	gupu
不得便相许	gtwy
不得春风花不开	gtdg
不得到辽西	gtgs
不得顾采薇	gtda
不得乎亲	gttu
不得其酱	gtau
不得其死然	gtaq
不得其所	gtar
不得收骨肉	gtnm
不得通其道	gtcu
不得吾心	gtgn
不得已而用之	gtnp
不得已也	gtnb
不得与之言	gtgy
不得志独行其道	gtfu
不得中行而与之	gtkp
卜尔	hhqi
不二法门无别路	gfik
不犯此	gqhx
不妨长作岭南人	gvtw
不分贫富	gwwp
不复东西征	gtat
不复理残机	gtgs
不复挺者	gtrf
不抚壮而弃秽兮	gruw
不改清阴待我归	gnij
不敢暴虎	gnjh
不敢不告也	gngb
不敢告劳	gnta
不敢过临洮	gnfi
不敢恨长沙	gnni
不敢请耳	gnyb
不敢为天下先	gnyt
不敢言而敢怒	gnyv
不敢倚先贤	gnwj
不敢饮食	gnqw
不共楚王言	gasy
不管风吹浪打	gtmr
不关情处总伤心	gunn
不贵难得之货	gkcw
不贵其师	gkaj
不过满腹	gfie
不过数仞而下	gfog
不过一枝	gfgs
不耗复不盈	gdte
不恒其德	gnat
步花间	hauj
不患莫己知	gkat
不患贫而患不安	gkwp
不患人之不己知	gkwt
不患无位	gkfw
不记归时节	gyja
不霁何虹	gfwj
不及卢家有莫愁	geht
不及石尤风	gedm
不稼不穑	gtgt
不嫁义郎体	gvyw
不见而明	gmdj
不见复关	gmtu
不见高人王右丞	gmyb
不见居人只见城	gmnf
不见君	gmvt
不见李生久	gmsq
不见其身	gmat
不见前年秋月朗	gmuy
不见水端	gmiu
不见一人来	gmgg
不见有人还	gmdg
不见诸侯	gmyw
不见子充	gmby
不见子都	gmbf
不教而杀谓之虐	gfdh
不教胡马渡阴山	gfdm
不戒视成谓之暴	gapj
不矜名节	gcqa
不近人情焉	grwg
不久当归还	gqig
不久当还归	gqij
不久望君来	gqyg
不居其薄	gnaa
不居其华	gnaw
不据山河据平地	grmf
不拘于时	grgj
不觉碧山暮	giga
不觉成长叹	gidk
不觉前贤畏后生	giut
不绝如缕	gxvx
不觉已鸣鸦	gina
不觉犹歌起夜来	giqg
不骏其德	gcat
不开悟	ggng
不堪持寄君	gfrv
不堪吏人妇	gfgv
不堪母驱使	gfxw
不堪人事日萧条	gfwt
不堪盈手赠	gfem
不可不察也	gsgb
不可不畏	gsgl
不可不语	gsgy
不可不知也	gsgb
不可长保	gstw
不可道也	gsub
不可得而	gstd
不可得而疏	gstn
不可得而闻也	gstb
不可得也	gstb
不可得矣	gstc
不可雕也	gsmb
不可读也	gsyb
不可多取	gsqb
不可方思	gsyl
不可沽名学霸王	gsig
不可乎不可	gsts
不可毁也	gsvb
不可及也	gseb
不可救乎	gsft
不可卷也	gsub
不可求思	gsfl
不可胜记	gsey
不可失也	gsrb
不可使知之	gswp
不可数计	gsoy
不可说也	gsyb
不可罔也	gsmb
不可为量数	gsyo
不可为也	gsyb
不可圬也	gsfb
不可陷也	gsbb
不可休息	gswt
不可选也	gstb
不可以长处乐	gsnq
不可以久处约	gsnx
不可以据	gsnr
不可以请	gsny
不可一日无此君	gsgv
不可以茹	gsna
不可以物	gsnt
不可以语上也	gsnb
不可泳思	gsil
不可则止	gsmh
不可执也	gsrb
不可转也	gslb
不肯低头在草莽	ghwa
不肯脱罗衣	ghey
不肯暂回车	ghll
不愧于人	gngw
不乐复何如	gqtv
不露文章世已惊	gfyn
不论军民	gypn
不寐倦长更	gpwg
不谋其政	gyag
不能成方圆	gcdl
不能废人运酒舫	gcyt
不能奋飞	gcdn
不能过也	gcfb
不能十步	gcfh
不能以礼让为国	gcnl
不能用也	gceb
不能正其身	gcgt
不能专对	gcfc
不拟回头望故乡	grlx
不念旧恶	gwhg
不念居安思危	gwnq
不念昔者	gwaf
不宁不令	gpgw
不怕醉	gnsg
不破楼兰终不还	gdsg
不其然乎	gaqt
不遣胡儿匹马还	gkdg
不寝听金钥	gpkq
不求友生	gfdt
不然烦恼万涂侵	gqow
不然则已	gqmn
不仁不智	gwgt
不忍见此物	gvmt
不忍见其死	gvmg
不忍食其肉	gvwm
不忍云间两分张	gvfx
不仁则辱	gwmd
不仁者远矣	gwfc
不仁之人	gwpw
不日不月	gjge
不日成之	gjdp
不日有曀	gjdj
不如不相见	gvgm
不如不行	gvgt
不如乘势	gvtr
不如待时	gvtj
不如高卧且加餐	gvyh
不如归去	gvjf
不如尽此花下欢	gvnc
不辱其身	gdat
不如丘之好学也	gvrb
不如仁人	gvww
不如是之甚也	gvjb
不入我门	gttu
不如我所之	gvtp
不如相忘于江湖	gvsi
不如学也	gvib
不如因善遇之	gvlp
不如友生	gvdt
不如早还家	gvjp
不如早还乡	gvjx
不入则止	gtmh
不如诸夏之无也	gvyb
不如子之衣	gvby
不如坐进此道	gvwu
不若相忘于江湖	gasi
不若与人	gagw
不若与众	gagw
不洒离别间	giyu
不善不能改	gugn
不善人者	guwf
不善人之师	guwj
不上不下	ghgg
不舍昼夜	gwny
不胜清怨却飞来	geig
不是宸游玩物华	gjpw
不是花中偏爱菊	gjaa
不是路	gjkh
不恃其成	gnad
不失其所者久	graq
不失其性命之情	gran
不是人间富贵花	gjwa
不使胜食气	gwer
不食五谷	gwgw
不仕无义	gwfy
不是杨花	gjsa
不是一人能领导	gjgn
不识有诸	gydy
不食之矣	gwpc
不狩不猎	gqgq
不似春光	gwdi
不死何俟	ggww
不俟驾行矣	gwlc
不思旧姻	glhv
不思其反	glar
不似颍川空使酒	gwxi
不素餐兮	gghw
卜算子慢	htbn
不随以止也	gbnb
不体认	gwyw
不脱蓑衣卧月明	geaj
不忘其所始	gyav
不亡以待尽	gynn
不为爱人	gyew
不为不多矣	gygc
不为登高	gywy
不为而成	gydd
不为福先	gypt
不为功名	gyaq
不为酒困	gyil
不为离人照屋梁	gyyi
不违农时	gfpj
不违如愚	gfvj
不为社者	gypf
不闻先王之遗言	guty
不我过	gtfp
不我活兮	gtiw
不我遐弃	gtny
不我信兮	gtww
不我以	gtny
不我以归	gtnj
不我与	gtgn
不吾知也	ggtb
不息恶木枝	gtgs
不惜珊瑚持与人	gngw
不习水土	gnif
不瑕有害	ggdp
不贤者识其小者	gjff
不向东山久	gtaq
不相见	gsmq
不向空门何处销	gtpq
不降其志	gbaf
不相为谋	gsyy
不相与为谋	gsgy
不祥之器	gppk
不笑不足以为道	gtgu
不信比来长下泪	gwxi
不信道	gwut
不信妾肠断	gwuo
不幸短命死矣	gftc
步行夺得胡马骑	htdc
不幸牺牲	gftt
不徐不疾	gtgu
不须惆怅怨芳时	genj
步虚词	hhyn
不须放屁	geyn
不须怀抱重凄凄	genu
步虚声	hhfn
不虚心	ghny
不学燕丹客	giap
不要这多雪	gsyf
不要这高	gsyy
不夜月临关	gyeu
不亦悲乎	gydt
不以兵车	gnrl
不以兵强天下	gnrg
不亿不信	gwgw
不以辞害志	gntf
不易得也	gjtb
不义而富且贵	gydk
不以规矩	gnft
不亦过乎	gyft
不亦可乎	gyst
不以礼节之	gnpp
不疑灵境难闻见	gxvm
不亦难乎	gyct
不以其道得之	gnap
不以人废言	gnwy
不以仁政	gnwg
不以人助天	gnwg
不以三隅反	gndr
不亦善乎	gyut
不亦甚乎	gyat
怖亦死	nygq
不以文害辞	gnyt
不亦宜乎	gypt
不宜有怒	gpdv
不以智治国	gntl
不饮盗泉水	gqui
不应回首	gylu
不盈顷筐	gext
不用登临恨落晖	gewj
不有博弈者乎	gdft
不忧不惧	gngn
不有雨兼风	gdfm
卜玉郎	hgyv
不与泥同调	ggiy
不与秦塞通人烟	ggdo
不与我食兮	ggtw
不与我言兮	ggtw
不与物交	ggtu
不欲以静	gwng
不与之为谋	ggpy
不远千里而来	gftg
步月	hiee
不曰白乎	gjrt
不曰坚乎	gjjt
不在其位	gdaw
不在颛臾	gdmv
不占而已矣	ghdc
不忮不求	gngf
不知答也	gttb
不知道也	gtub
不知地之厚也	gtfb
不知东方之既白	gtar
不知东走迷	gtao
不知端倪	gtuw
不知何处吊湘君	gtwv
不知何处归	gtwj
不知何处是他乡	gtwx
不知何道士	gtwf
不知几何时	gtmj
不知今夕是何年	gtwr
不知命也	gtwb
不知其不胜任也	gtab
不知其几千里也	gtab
不知其尽也	gtab
不知其期	gtaa
不知其仁	gtaw
不知其人可乎	gtat
不知其仁也	gtab
不知其所	gtar
不知墙外是谁家	gtfp
不知秋思在谁家	gttp
不知身世自悠悠	gttw
不知谁家子	gtyb
不知说生	gtyt
不知所以裁之	gtrp
不治天下	gigg
不知天之高也	gtgb
不知恶死	gtgg
不知西东	gtsa
不知香积寺	gttf
不知心恨谁	gtny
不知学问之大也	gtib
不知有之	gtdp
不知园里树	gtls
不知元是此花身	gtft
不知云与我俱东	gtfa
不知周也	gtmb
不周山下红旗乱	gmmt
不主故常	gydi
不庄以莅之	gynp
不自得而得彼者	gttf
不自著罗衣	gtay
不足多也	gkqb
不足以取天下	gkng
不足以为士矣	gknc
不足迎后人	gkqw
采柏动盈掬	esfr
采采芣苡	eeaa
采采衣服	eeye
采蘩	esat
采蘩祁祁	eapp
采葑采菲	eaea
彩凤飞	emnu
裁缝寄远道	fxpu
蔡孚	aweb
采芙蓉	eaap
采葛	esaj
蔡瑰	awgr
才见岭头云似盖	fmmu
蔡戡	awad
才可容颜十五馀	fspq
采苦采苦	eaea
蔡昆	awjx
采莲从小惯	eawn
采莲归	eajv
采莲花	eaaw
采莲女	eavv
采莲舟	eate
采莲子	eabb
采苓	esaw
彩鸾空自舞	eypr
采明珠	ejgr
材木不可胜用	ssge
材木不可胜用也	ssgb
才能不及中人	fcgw
蔡女昔造胡笳声	avaf
采苹	esag
采芑	esan
蔡确	awdq
采桑绿水边	ecxl
采桑子重阳	ecbb
采山因买斧	emlw
采荼薪樗	eaas
采薇采薇	eaea
蔡文恭	ayaw
财物无所取	mtfb
才饮长江水	fqti
材与不材之间	sggu
蔡允恭	acaw
残杯与冷炙	gsgq
蚕丛及鱼凫	gweq
残灯无焰影幢幢	gofm
残花落尽见流莺	gaaa
蚕饥妾欲去	gquf
蚕眠桑叶稀	ghct
残宵犹得梦依稀	gpqt
残星拂大旗	gjry
残雪乱山中	gftk
残阳如血	gbvt
残阳西入崦	gbsm
残夜水明楼	gyis
残莺何事不知秋	gawt
残萤栖玉露	gasf
残月几人行	gemt
残月落花烟重	geat
残月下寒沙	gegi
残月下章台	gegc
残云归太华	gfjw
残云收夏暑	gfnj
残贼之人	gmpw
残钟广陵树	gqys
残妆和泪污红绡	gutx
苍苍横翠微	aast
仓庚喈喈	wykk
沧海成桑田	iidl
沧海得壮士	iitf
沧海横流	iisi
沧海横流安足虑	iish
沧海月明珠有泪	iiei
沧江好烟月	iive
沧江急夜流	iiqi
沧浪亭记	iiyy
沧浪之水清兮	iipw
沧浪之水浊兮	iipw
苍茫对落晖	aacj
苍茫古木连穷巷	aada
苍茫云海间	aafu
苍然满关中	aqik
苍山夹乱流	amgi
苍山如海	amvi
藏书万卷可教子	andb
苍天苍天	agag
苍梧山崩湘水绝	asmx
苍梧谣	asye
苍崖渺难涉	amii
苍鹰画作殊	aygg
苍蝇之声	ajpf
藏之名山	apqm
曹豳	gmee
草不谢荣于春风	agym
草草杯盘供笑语	aasy
草创未就	awfy
曹风	gmmq
草夫人	afww
草绿长门掩	axtr
草绿湖南万里情	axin
草木畅茂	asja
草木茂萌芽	asaa
草木有本心	asdn
草铺横野六七里	aqsj
草如茵	aval
草色青青柳色黄	aqga
草色新雨中	aquk
草上之风	ahpm
草尚之风必偃	aipw
曹生	gmtg
草市迎江货	ayqw
草书歌行	anst
曹松	gmsw
曹唐	gmyv
曹文姬	gyva
草屋八九间	anwu
曹邺	gmog
曹遇	gmjm
曹宰	gmpu
曹著	gmaf
侧犯	wmqt
侧见双翠鸟	wmcq
侧目似愁胡	whwd
侧身西望常咨嗟	wtsk
侧身西望长咨嗟	wtsk
恻隐之心	nbpn
参差连曲陌	culb
岑夫子	mfbb
岑夫子丹丘生	mfbt
岑羲	mwug
层冰积雪摧残	nutg
曾冰延乐方	uuty
曾不容刀	ugpv
层城四望开	nflg
曾诞	ulyt
曾到尚书墓上来	ugig
曾觌	ulfn
曾栋	ulsa
曾记否	uygi
曾将秋竹竿	uutt
曾经学舞度芳年	uxir
曾开国	uglg
曾苦伤春不忍听	uawk
曾揆	ulrw
曾隶	ulvi
层林尽染	nsni
曾驱十万师	ucfj
曾是寂寥金烬暗	ujpj
曾是以为孝乎	ujnt
曾无黄石公	ufaw
曾协	ulfl
曾由与求之问	umgu
曾允元	ucfq
曾肇	ulyn
曾照吴王宫里人	ujkw
曾逐东风拂舞筵	ueat
察臣孝廉	pafy
差池不相见	uigm
差池其羽	uian
察乎盈虚	pteh
察邻国之政	pwlg
茶瓶儿	auqt
察言而观色	pydq
茶烟轻扬落花风	aolm
插羽破天骄	rndc
柴夔	hxuh
豺狼尽冠缨	eqnx
豺狼在邑龙在野	eqdj
柴门鸟雀噪	huqk
柴望	hxyn
蟾蜍蚀圆影	jjqj
禅峰	pymt
缠绵成一家	xxdp
蝉鸣空桑林	jkps
蝉休露满枝	jwfs
单于猎火照狼山	ugqm
单于已在金山西	ugns
长安白日照春空	tprp
长安不见使人愁	tpgt
长安城连东掖垣	tpff
长安城头头白乌	tpfq
长安城中月如练	tpfx
长安大道连狭斜	tpdw
长安宫阙九天上	tpph
长安年少惜春残	tprg
长安女	tpvv
长安秋望	tpty
长安市上酒家眠	tpyh
长安水边多丽人	tpiw
长安一片月	tpge
长安遇冯著	tpja
长安早春	tpjd
长飙风中自来往	tdmt
长不掩兰房	tgry
长春	tadw
常存抱柱信	idrw
长岛人歌动地诗	tqwy
常德不离	itgy
常德乃足	itek
常棣	ipsv
常棣之华	ispw
长簟迎风早	ttqj
肠断春江欲尽头	eodu
肠断更无疑	eogx
肠断江城雁	eoid
肠断未忍扫	eofr
长而不宰	tdgp
长而无述焉	tdfg
长而异俗	tdnw
长风吹林雨堕瓦	tmkg
长风吹月度海来	tmkg
长风几万里	tmmj
长风连日作大浪	tmli
长干行	tftf
长歌楚天碧	tssg
长歌怀旧游	tsni
长歌吟松风	tskm
常衮	ipuc
常浩	ipit
长河渐落晓星沈	tiii
长河浪头连天黑	tiil
长河没晓天	tiig
长记别伊时	tykj
长记平山堂上	tygh
长铗归来乎	tqjt
长剑一杯酒	twgi
长江悲已滞	tidi
长江独至今	tiqw
长江绕郭知鱼美	tixu
长江一帆远	tigf
尝居于此	ingh
常恐秋风早	iatj
长空雁叫霜晨月	tpde
长乐王回深父	tqgw
长乐钟声花外尽	tqqn
长眉已能画	tnng
长门尽日无梳洗	tuni
长门一步地	tugf
长命女	twvv
长命无绝衰	twfy
长宁公主	tpwy
长桥卧波	tsai
长桥月	tsee
怅然遥相望	nqey
怅然吟式微	nqkt
长沙不久留才子	tigb
长沙过贾谊宅	tifp
长沙马王堆汉墓	tica
长沙谪去古今怜	tiyn
常善救物	iuft
长绳系日住	txtw
长生久视之道	ttqu
长生乐	ttqi
常使民无知	iwnt
长寿乐	tdqi
长孙氏	tbqa
长亭窗户压微波	typi
长亭酒一瓢	tyis
长亭怨	tyqb
怅望江头江水声	nyif
怅望千秋一洒泪	nyti
怅望银河吹玉笙	nyqt
怅卧新春白袷衣	nauy
长我育我	ttyt
长夏江村事事幽	tdix
常羡人间琢玉郎	iuwy
长相思摧心肝	tsle
长相思令	tslw
长相思在长安	tslp
长信宫中秋月明	twpj
常雅	ipah
长夜难明赤县天	tycg
常沂	ipir
常以身翼蔽沛公	intw
长一身有半	tgtu
倡优畜之	wwyp
倡予和女	wctv
常于几成而败之	igmp
长于水而安于水	tgii
长愿向南流	tdti
常在床蓐	idya
常在於险远	idyf
长征	tatg
长之育之	tpyp
畅诸	jhyf
长作东南别	twak
常作去年花	iwfa
朝罢须裁五色诏	fley
朝避猛虎	fnqh
朝别黄鹤楼	fkas
晁采	jies
朝餐是草根	fhjs
朝成绣夹裙	fdxp
晁冲之	jupp
晁端礼	jupy
晁公武	jwga
朝衡	fjtq
朝回日日典春衣	fljy
朝扣富儿门	frpu
潮来天地青	iggg
潮落江平未有风	iaim
潮落夜江斜月里	iayj
朝三而暮四	fddl
朝天乐	fgqi
朝同一源出	fmgb
朝闻游子唱离歌	fuis
朝闻游子唱骊歌	fuis
朝与佳人期	fgwa
巢在三珠树	vdds
朝中措	fkra
车迟迟	lnny
车攻	lgat
车邻	lgwy
车辚辚	lllo
车马去闲闲	lcfu
车如鸡栖马如狗	lvcq
车如流水马如龙	lvid
车胤	lgtx
车走雷声语未通	lffc
尘埃不见咸阳桥	ifgs
陈黯	balf
沉彬	ipss
陈昌言	bjyy
沉沉无问处	iift
沉沉一线穿南北	iigu
陈乘	batu
陈成之	bdpp
陈璀	bagm
陈存	badh
陈德武	btga
陈东甫	bage
陈璠	bagt
陈凤仪	bmwy
陈合	bawg
陈侯立身何坦荡	bwua
陈祜	bapy
陈季	batb
陈季卿	btqt
陈嘉言	bfyy
陈京	bayi
臣具以表闻	ahnu
陈康伯	bywr
陈亢退而喜曰	byvj
陈贶	bamk
陈力就列	blyg
陈睦	bahf
瞋目视项王	hhpg
尘泥渗漉	iiii
陈凝	baux
晨前命对朝霞	juwf
陈峤	bamt
陈情事表	bngg
陈去疾	bfut
陈日章	bjuj
臣少多疾病	aiqu
陈涉之位	bipw
称身不必狐裘	ttgf
臣生当陨首	atiu
陈师道	bjut
陈师鞠旅	bjay
臣事君以忠	agvk
尘世难逢开口笑	iact
臣弑其君者有之	aqap
陈叔达	bhdp
臣死且不避	agen
臣虽下愚	akgj
陈孙	babi
陈陶	babq
陈王昔时宴平乐	bgaq
陈韡	banh
臣为韩王送沛公	ayfw
陈维崧	bxms
臣未之闻也	afpb
臣闻求木之长者	auff
臣无祖母	afpx
陈希烈	bqgq
陈袭善	bdud
陈相见孟子	bsmb
沉香亭北倚阑干	ityf
陈偕	bawx
称心快意	tnnu
尘心未尽思乡县	infe
陈彦博	bufg
晨摇玉佩趋金殿	jrgn
陈翊	baun
臣以供养无主	anwy
臣以险衅	anbt
臣欲奉诏奔驰	awdc
陈与兴	bgiw
陈元初	bfpu
陈元光	bfiq
陈元裕	bfpu
陈慥	bant
臣战河南	ahif
陈至	bagc
臣之进退	apfv
臣之事君	apgv
臣之所好者道也	aprb
陈之贤	bpjc
臣之辛苦	apua
陈子良	bbyv
陈祖安	bppv
沉醉东风	isam
成败之数	dmpo
乘彼白云	ttrf
乘彼垝垣	ttff
城边有古树	flds
诚不以富	ygnp
程长文	ttyy
澄澄变今古	iiyd
乘乘马	ttcn
澄澄映葭苇	iija
程大昌	tdjj
承恩不在貌	blge
承恩数上南熏殿	blon
城非不高也	fdgb
乘桴浮于海	tsii
城高倚峭巘	fywm
程公许	twyt
成固有伐	dldw
程过	tkfp
程贺	tklk
成吉思汗	dfli
承籍有宦官	btdp
澄江平少岸	iigm
成就河沙梦功德	dyit
承筐是将	btju
程邻	tkwy
称其德也	tatb
乘骐骥以驰骋兮	tccw
城阙夜千重	fuyt
城上风威冷	fhmu
城上高楼接大荒	fhya
成事不说	dggy
承天景命	bgjw
承天寺夜游	bgfi
城头铁鼓声犹振	fuqr
城头铁鼓声犹震	fuqf
城头月	fuee
程武	tkga
程先	tktf
城小贼不屠	fimn
乘兴南游不戒严	tifg
成彦雄	dudc
成一家之言	dgpy
乘殷之辂	trpl
诚有百姓者	yddf
成由勤俭破由奢	dmad
程正同	tgmg
诚知此恨人人有	ythd
城中十万户	fkfy
城中相识尽繁华	fksw
城中增暮寒	fkfp
乘舟将欲行	ttut
程准	tkuw
赤壁词	fnyn
赤壁歌送别	fnsk
赤壁怀古	fnnd
赤橙黄绿青蓝紫	fsah
驰骋畋猎	cclq
驰骋天下之至坚	ccgj
迟迟白日晚	nnrj
持此谢高鸟	rhyq
持而保之	rdwp
池非不深也	idgb
池潢不敢顾	iigd
迟回度陇怯	nlyn
持家但有四立壁	rpwn
池口风雨留三日	ikmj
耻令越甲鸣吾君	bwfv
魑魅魍魉惊本身	rrrt
魑魅魍魉徒为尔	rrrq
魑魅魍魉徒为耳	rrrb
魑魅喜人过	rrff
迟日园林悲昔游	njli
齿如瓠犀	hvdn
池上风回舫	ihmt
持觞劝侯嬴	rqcy
池台日半斜	icjw
耻为游子颜	byiu
絺兮绤兮	xwxw
持谢邻家子	rywb
赤焰烧虏云	foof
赤也何如	fbwv
赤也为之小	fbyi
持一象笏至	rgqg
池月渐东上	ieih
赤枣子	fgbb
赤之适齐也	fptb
重重似画	ttwg
重叠金	tcqq
重过圣女祠	tfcp
宠极爱还歇	psej
重九开秋节	tvga
充满天地	yigf
虫鸣室幽幽	jkpx
宠命优渥	pwwi
宠辱若惊	pdan
重上井冈山	thfm
重上君子堂	thvi
重言十七	tyfa
充虞路问曰	yhkj
筹笔驿	ttcc
惆怅长岑长	nntt
惆怅赤城期	nnfa
惆怅暮烟垂	nnat
惆怅南朝事	nnfg
惆怅墙东	nnfa
惆怅无因见范蠡	nnfx
愁春未醒	tdfs
愁多酒虽少	tqii
愁多梦不成	tqsd
愁风月	tmee
丑妇可与白头	nvsu
酬郭给事	syxg
愁红惨绿	txnx
愁看直北是长安	trfp
愁空山	tpmm
愁来一日即为长	tggt
绸缪束薪	xxga
丑奴儿	nvqt
丑奴儿令	nvqw
丑奴儿慢	nvqn
丑女效之徒累身	nvut
愁人独夜看	twqr
愁杀芳年友	tqad
愁思看春不当春	tlrd
愁心似醉兼如病	tnwu
愁绪乱春风	txtm
愁颜与衰鬓	tugd
愁倚阑	twug
愁倚阑令	twuw
愁倚两三松	twgs
愁因薄暮起	tlaf
愁云黪淡万里凝	tflu
酬张少府	sxiy
初八月	pwee
触波涛	qiid
楚臣伤江枫	saws
除臣洗马	baic
处处伴愁颜	ttwu
处处黄芦草	ttaa
触处似花开	qtwg
处处销魂	ttqf
楚词体	syws
初弹渌水后楚妃	pxiv
出洞无论隔山水	bifi
初冬夜饮	ptyq
楚儿	ssqt
处分适兄意	twtu
储光羲	wiug
出乎尔者	btqf
初既与余成言兮	pvgw
出疆必载质	bxnr
楚江东	siai
楚江怀古	sind
楚江微雨里	sitj
出郊旷清曙	bujj
初惊河汉落	pnia
触景生情	qjtn
楚客相思益渺然	spsq
楚客欲听瑶瑟怨	spwq
楚狂接舆	sqrw
褚亮	puyp
楚路高歌自欲翻	skyt
出门登车去	buwf
出门如见大宾	buvp
出门搔白首	buru
出门无侣漫看书	bufn
出门行	butf
出门一笑大江横	bugs
处默	thlf
出纳之吝	bxpy
楚娘	ssvy
楚女当时意	sviu
出其东门	baau
初七及下九	paev
处前而民不害	tudp
怵然为戒	nqya
初日郢门山	pjkm
出入腹我	btet
出入高下穷烟霏	btyf
出塞复入塞	bptp
出塞入塞寒	bptp
楚塞三湘接	spdr
楚山横地出	smsb
楚山秦山皆白云	smdf
出山泉水浊	bmri
出身仕汉羽林郎	btwy
褚生	putg
杵声齐	sfyj
出生入死	bttg
初生欲缺虚惆怅	ptwn
出世和入世	bata
处世若大梦	taas
储嗣宗	wkpf
初随林霭动	pbsf
初随骠骑战渔阳	pbcb
楚天长短黄昏雨	sgtf
楚天谣	sgye
楚王台榭空山丘	sgcr
初为霓裳后六么	pyft
初闻征雁已无蝉	putj
除夜有怀	bydn
初疑路不同	pxkm
初因避地去人间	plnu
楚有春申	sddj
出于林中	bgsk
楚云深	sfip
出则不知其所往	bmgt
出则事公卿	bmgq
褚朝阳	pfbj
楚之南有冥灵者	spff
处众人之所恶	twwg
出自北门	btuu
出自东方	btay
出自幽谷	btxw
楚左尹项伯者	sdvf
川波岸柳春全回	kiml
川拨棹	krsh
传歌共绕梁	wsai
川迥洞庭开	kmig
传其常情	wain
船上管弦江面绿	thtx
川为静其波	kygi
传闻至此回	wugl
船下广陵去	tgyf
传言玉女	wygv
传语风光共流转	wyml
川原迷旧国	kdol
传之其人	wpaw
传之七十有二代	wpaw
摐金伐鼓下榆关	rqwu
窗迥侵灯冷	pmwu
床前看月光	yuri
窗外疏梅筛月影	pqnj
创业艰难百战多	wocq
吹彼棘心	ktgn
吹彼棘薪	ktga
垂碧柳	tgsq
吹不散眉弯	kgay
槌床便大怒	sywv
吹笛风斜隔陇闻	ktmu
垂钓将已矣	tquc
垂钓绿湾春	tqxd
吹洞箫	kitv
吹度玉门关	kygu
吹断檐间积雨声	kosf
垂拱而治	trdi
吹花送远香	kaut
垂老不得安	tfgp
吹落白衣裳	kari
吹人舞袖回	kwrl
垂緌饮清露	txqf
吹散万里云	kadf
吹笙鼓簧	ktft
垂死病中惊坐起	tguf
垂丝钓	txqq
垂阳	tgbj
垂杨柳	tssq
垂衣贵清真	tykf
春别	dwkl
春病	dwug
春不能朱镜里颜	dgcu
春草碧	dagr
春草闭闲门	dauu
春草明年绿	dajx
春草如有情	davn
春草昭阳路断	dajo
春蝉	dwju
春潮夜夜深	diyi
春城紫禁晓阴阴	dfhb
春愁黯黯独成眠	dtlh
春窗曙灭九微火	dpjo
春从天上来	dwgg
春泛若耶溪	diai
春风不相识	dmgy
春风春雨花经眼	dmdh
春风啜茗时	dmkj
春风得意	dmtu
春风对青冢	dmcp
春风尔来为阿谁	dmqy
春风海上楼	dmis
春风举国裁宫锦	dmiq
春风柳上归	dmsj
春风袅娜	dmqv
春风十里扬州路	dmfk
春风桃李花开日	dmsj
春风笑人来	dmtg
春风杨柳万千条	dmst
春风一等少年心	dmgn
春风倚棹阖闾城	dmwf
春风语流莺	dmya
春风争拟惜长条	dmqt
春服既成	devd
春歌	dwsk
春歌丛台上	dswh
春宫曲	dpma
春宫怨	dpqb
春光半道催	diuw
春光好	divb
春光懒困倚微风	dinm
春光融融	digg
春归怨	djqb
春归在客先	djdt
春寒花较迟	dpan
春鸠	dwvq
春鸠鸣何处	dvkt
春来遍是桃花水	dgyi
春来长是闲	dgtu
春来还发旧时花	dgga
春来酿几多	dgsq
春来我不先开口	dgtk
春流绕蜀城	dixf
春露到秋风	dfgm
春娘	dwvy
春弄	dwga
春晴	dwjg
春情著杏花	dnaa
春秋不变	dtgy
春去不容惜	dfgn
春去夏犹清	dfdi
春去也	dfbn
春日迟迟	djnn
春日凝妆上翠楼	djus
春日偏能惹恨长	djwt
春日潜行曲江曲	djim
春日望海	djyi
春日行	djtf
春日在天涯	djdi
春日载阳	djfb
春日醉起言志	djsf
春入万年枝	dtds
春色满	dqia
春色满皇州	dqiy
春色恼人眠不得	dqnt
春色岂知心	dqmn
春色属明年	dqnr
春色未曾看	dqfr
春衫泪	dpih
春深杏花乱	dist
春生江上几人还	dtig
春水船如天上坐	ditw
春思	dwln
纯素之道	xgpu
春宿左省	dpdi
春天和	dgtk
春夏两相期	ddga
春宵曲	dpma
春晓曲	djma
春心荡	dnai
春雪满空来	dfig
春莺转	dalf
春雨	dwfg
春与青溪长	dggt
春与秋其代序	dgty
春怨	dwqb
春远独柴荆	dfqa
春早湖山	djim
鹑之奔奔	ypdd
春逐五更来	degg
此别何时遇	hkwj
辞不赴命	tgfw
辞不就职	tgyb
赐不受命	mgew
此大年也	hdrb
此道昔归顺	huak
此道引之士	huxf
此地别燕丹	hfkm
此地两三家	hfgp
此二子者	hfbf
慈父见背	uwmu
辞富居贫	tpnw
此妇无礼节	hvfa
此何人哉	hwwf
此花开尽更无花	haga
此会在何年	hwdr
辞家见月两回圆	tpml
辞家终拟长游衍	tpxt
此江海之士	hiif
此酒不足尝	higi
词开豪放一派	ygyi
词客哀时且未还	ypyg
辞楼下殿	tsgn
此率兽而食人也	hyub
赐名大国虢与秦	mqdd
此木岂无阴	hsmb
此平世之士	hgaf
刺破青天锷未残	gdgg
此其比万物也	haxb
此其志不在小	hafi
此情不可道	hngu
此情可待成追忆	hnsn
此情惟有落花知	hnnt
此去随所偶	hfbw
此去瑶池地共长	hfgt
此曲有意无人传	hmdw
辞让之心	typn
此人已成灰	hwnd
此日登临曙色开	hjwg
此日意无穷	hjup
此日足可惜	hjkn
此山谷之士	hmwf
此生此夜不长好	hthv
此时此夜难为情	hjhn
此事何难	hgwc
此虽免乎行	hkqt
此天地之道	hgfu
此天子气也	hgbb
此亡秦之续耳	hydb
此谓诚忘	hyyy
此谓坐忘	hywy
此翁白头真可怜	hwrn
此夕闻君谪九江	hqui
此夕相逢	hqst
此小大之辩也	hidb
此小年也	hirb
此心安处是吾乡	hnpx
此心向君君应识	hnty
此行不为鲈鱼鲙	htgq
此行何去	htwf
赐也何敢望回	mbwl
赐也何如	mbwv
此夜红楼	hyxs
赐也贤乎哉	mbjf
此亦飞之至也	hynb
此一时也	hgjb
此亦一是非	hygd
此余之所得也	hwpb
词源倒流三峡水	yiwi
赐之墙也及肩	mpfy
此之谓物化	hpyw
此之谓也	hpyb
赐之彘肩	mpxy
此州独见全	hyqw
辞尊居卑	tunr
从臣才艺咸第一	wafg
从此道至吾军	whup
从此各东西	whts
从此天涯孤旅	whgy
从从容容	wwpp
从今四海为家日	wwlj
从今又几年	wwcr
丛菊两开他日泪	wagi
从来多古意	wgqu
从来急	wgqv
従来佳茗似佳人	tgww
从来系日乏长绳	wgtx
从来幽并客	wgxp
从郦山下	wgmg
从孙子仲	wbbw
从汀州向长沙	wiyi
从头翻悔	wutn
从头越	wufh
从吾所好	wgrv
从余问古事	wwug
从者见之	wfmp
醋葫芦	saay
蹙金孔雀银麒麟	dqby
簇水	tyii
蹙缩又纵横	dxcs
粗缯大布裹生涯	oxdi
崔备	mwtl
崔邠	mwwv
摧藏马悲哀	racy
催臣上道	wahu
崔琮	mwgp
崔涤	mwit
崔峒	mwmm
崔敦礼	mypy
崔耿	mwbo
崔恭	mwaw
崔瓘	mwga
崔珪	mwgf
崔国辅	mllg
崔何	mwws
翠花拂天来向东	nara
翠华想像空山里	nwsj
翠华引	nwxh
崔怀宝	mnpg
崔绩	mwxg
崔江	mwia
崔郊	mwuq
崔珏	mwgg
崔立言	muyy
崔立之	mupp
崔橹	mwsq
崔沔	mwig
崔木	mwss
崔璞	mwgo
崔翘	mwat
崔日用	mjet
崔融	mwgk
崔尚	mwim
崔湜	mwij
崔曙	mwjl
崔枢	mwsa
崔颂	mwwc
崔素娥	mgvt
崔涂	mwiw
翠微盍叶垂鬓唇	ntfd
崔嵬枝干郊原古	mmsd
催弦拂柱与君饮	wxrq
摧心肝	rnef
崔信明	mwje
崔兴宗	mipf
崔萱	mwap
崔轩	mwlf
崔铉	mwqy
崔玄亮	myyp
催雪	wmfv
崔郾	mwaj
崔液	mwiy
翠影红霞映朝日	njxj
崔庸	mwyv
翠羽吟	nnkw
崔与之	mgpp
崔员外	mkqh
粹之至也	opgb
崔中	mwkh
翠竹黄花皆佛性	ntan
崔子弑齐君	mbqv
崔紫云	mhfc
崔宗之	mppp
村边杏花白	slsr
寸步曲江头	fhmu
存乎人者	dtwf
村舍外	swqh
寸心千里	fntj
存者无消息	dfft
蹉跎岁月	kkme
大柏地	dsfb
大辩不言	dugy
大车槛槛	dlss
大车扬飞尘	dlri
大城铁不如	dfqv
大椿	ddsd
大盗不止	dugh
大道泛兮	duiw
大刀将军	dvup
大盗乃止	dueh
大道如青天	duvg
大道甚夷	duag
大道直如发	dufn
大德不逾闲	dtgu
大堤曲	dfma
大堤上	dfhh
大地微微暖风吹	dftk
大地微微暖气吹	dftk
大渡桥横铁索寒	disp
大而无当	ddfi
大而无用	ddfe
大风方发狂	dmyq
大旱金石流	djqi
大河上下	dihg
大濩	ddia
大江东流去	diaf
大江东去日夜白	diar
大江翻澜神曳烟	dito
大江茫茫去不还	diag
大江茫茫去不黄	diaa
大江溯轻舟	diit
大江西	disg
大军之后	dppr
大君制六合	dvrw
大类女郎也	dovb
大礼不辞小让	dpgy
答李淑一	tsig
大略驾群才	dllf
大明夜已残	djyg
达命之情者	dwpf
大漠穷秋塞草衰	dipy
大漠无兵阻	difb
大母过余曰	dxfj
大鹏飞兮振八裔	deny
打起黄莺儿	rfaq
大器晚成	dkjd
大千世界百杂碎	dtad
大仁不仁	dwgw
大人弗为	dwxy
大人故嫌迟	dwdn
达人无不可	dwfs
大厦如倾要梁栋	ddvs
大韶	dduj
大圣不作	dcgw
大圣乐	dcqi
大叔于田	dhgl
大舜有大焉	dedg
大蒐王道	dagu
大通智胜佛	dctw
大王来何操	dggr
大屋欹倾小成倒	dndw
大弦长	dxta
大贤虎变愚不测	djhi
大象无形	dqfg
大小必双翔	dinu
大小都不类	difo
大笑向文士	dttf
答谢中书书	tykn
大行不顾细谨	dtgy
大雪压青松	dfds
大雅久不作	daqw
达亦不足贵	dygk
大隐金门是谪仙	dbqw
大音自成曲	dutm
大勇不忮	dcgn
大有径庭	ddty
大愚	ddjm
大雨落幽燕	dfaa
大哉孔子	dfbb
大醉作此篇	dswt
迨此独忡忡	chqn
待到雪化时	tgfj
待得群花过后	ttvr
殆而已矣	gdnc
逮奉圣朝	vdcf
带甲满天地	glif
待酒不至	tigg
玳梁谁道好	giyv
带马行	gctf
黛眉偎破未重描	wnwr
迨其吉兮	cafw
迨其今兮	caww
黛色参天二千尺	wqcn
戴山隐	fmbq
戴叔伦	fhww
殆为此也	gyhb
待我适东越	tttf
待吾还丹成	tggd
待晓堂前拜舅姑	tjiv
戴翼	fanl
戴盈之曰	fepj
殆有甚焉	gdag
待月池台空逝水	teii
代赠二首	wmfu
带之适也	gptb
迨诸父异爨	cyww
但当对石饮	wicq
但道困苦乞为奴	wulv
但得酒中趣	wtif
弹洞前村壁	xiun
旦而哭泣	jdki
旦而田猎	jdlq
丹凤城南秋夜长	mmft
丹凤吟	mmkw
惮赫千里	nftj
弹痕遍地	xuyf
但恨无过王右军	wnfp
淡乎其无味	itak
但记得斑斑点点	wyth
但见悲鸟号古木	wmds
但见泪痕湿	wmii
但见群鸥日日来	wmvg
但见三泉下	wmdg
但见宵从海上来	wmpg
但见新人笑	wmut
但将酩酊酬佳节	wusa
但看古来歌舞地	wrdf
但看古来盛名下	wrdg
但恐花不实	waap
但令归有日	wwjj
丹青画出是君山	mggm
丹青引	mgxh
丹丘生	mrtg
丹丘信云远	mrwf
但去莫复问	wfau
但去莫复闻	wfau
澹然空水对斜晖	iqpj
澹然离言说	iqyy
旦日飨士卒	jjxy
淡扫蛾眉朝至尊	irju
淡扫明湖开玉镜	irjq
丹砂访葛洪	mdyi
但使主人能醉客	wwyp
澹兮其若海	iwai
但相思	wsln
丹崖翠壁千万丈	mmnd
但言浑忘不言无	wyif
丹阳郭里送行舟	mbyt
丹阳湖	mbid
但以刘日薄西山	wnym
但用东山谢安石	wead
但愿长醉不复醒	wdts
但愿长醉不愿醒	wdts
但远山长	wfmt
但愿天下人	wdgw
丹灶初开火	mopo
当待东宫	itap
当花侧帽	iawm
当今世界殊	iwag
当今之时	iwpj
当君怀归日	ivnj
当流赤足蹋涧石	iifd
当路谁相假	ikyw
当垆笑春风	iftm
当面输心背面笑	idlt
当年鏖战急	iryq
当年拼却醉颜红	irrx
当年颇似寻常人	irhw
当仁不让于师	iwgj
当时敌陕郛	ijte
当时堕地觅不得	ijbt
当时共客长安	ijap
当时浣纱伴	ijiw
当是时也	ijjb
当时只记入山深	ijki
当轩对尊酒	ilci
当轩下马入锦茵	ilga
荡漾不成圆	aigl
当尧之时	iapj
倒碧峰	wgmt
道不可见	ugsm
道不可闻	ugsu
道不可言	ugsy
到处潜悲辛	gtiu
到处莺歌燕舞	gtar
倒垂柳	wtsq
叨叨令	kkwy
道德三皇五帝	utdu
道德无多只本心	utfn
到而今	gdwy
道恭	utaw
倒海翻江卷巨澜	witi
道兼于天	uugg
捣练子	rxbb
捣练子令	rxbw
道路入边城	uktf
道路阻且长	ukbt
稻米流脂粟米白	toir
道旁过者问行人	uufw
道千乘之国	uttl
道人庭宇静	uwyg
到韶山	gumm
捣麝成尘香不灭	rydg
道是无情还有情	ujfn
道束悬崖半	ugeu
道听而途说	ukdy
到潼关	giud
道通为一	ucyg
道无终始	ufxv
道相似也	uswb
道心惟微	unnt
倒行逆施畏日晚	wtuj
道亦乐得之	uyqp
盗亦有道乎	uydt
导引	nfxh
道隐于小成	ubgd
道由白云尽	umrn
道与之貌	ugpe
盗贼多有	umqd
盗贼无有	umfd
道之不行	upgt
道之出口	upbk
道之斯行	upat
道之为物	upyt
道芷阳间行	uabt
导之以德	npnt
导之以政	npng
道之云远	upff
到中流击水	gkii
得成比目何辞死	tdxg
得春令慢	tdwn
得地本虚心	tfsn
得非施斧斤	tdyr
得复见将军于此	ttmh
德合一君	twgv
德兼于道	tugu
得乐天书	tqgn
得陇又望蜀	tbcl
得其所哉	tarf
得胜令	tewy
得死似登仙	tgww
得天下有道	tggu
得兔而忘蹄	tqdk
得无金丸惧	tfqn
德也狂生耳	tbqb
得意而忘言	tudy
德亦乐得之	tyqp
德以象贤	tnqj
德音不忘	tugy
德音孔昭	tubj
德音莫违	tuaf
得鱼而忘荃	tqda
得与亡孰病	tgyu
德之不修	tpgw
德之流行	tpit
德之末也	tpgb
德之弃也	tpyb
得志与民由之	tfgp
德之贼也	tpmb
德之至也	tpgb
登大雷岸与妹书	wdfn
磴道盘虚空	dutp
登峨眉山	wmnm
登高不可以为长	wygt
登高不栗	wygs
登高丘	wyrg
登高丘而望远	wyrf
登高丘而望远海	wyri
登高壮观天地间	wyuu
灯火钱塘三五夜	ooqy
登即相许和	wvst
登江中孤屿	wikm
登九峰楼	wvms
登乐游原	wqid
登临不惜更沾衣	wjgy
登临出世界	wjbl
登临吴蜀横分地	wjkf
登垄课儿锄	wdyq
登楼寄王卿	wspq
邓肃	cbvi
登太白峰	wdrm
灯下白头人	ogrw
灯下草虫鸣	ogak
邓倚	cbwd
邓攸无子寻知命	cwfw
灯月交辉	oeui
邓陟	cbbh
登舟望秋月	wtye
地白风色寒	frmp
地崩山摧壮士死	fmmg
地不得不广	fgty
帝臣不蔽	uaga
涤除玄鉴	ibyj
帝春台	udck
帝得圣相相曰度	utcy
地得一以宁	ftgp
滴滴金	iiqq
底底切切	yyaa
蝃蝀	jcjg
地动三河铁臂摇	ffdr
地方千里	fytj
帝高阳之苗裔兮	uybw
地静人闲月自妍	fgwv
敌军围困万千重	tplt
敌可摧	tsrm
低空有断云	wpdf
地脉象牙东	feqa
笛弄晚风三四声	tgjf
地气郁结	frdx
帝遣银河一派垂	ukqt
地若不爱酒	fagi
低头共耳语	wuay
低头向暗壁	wutn
地无不载	ffgf
地无私载	fftf
地无为以之宁	ffyp
地下若逢陈后主	fgay
帝乡不可期	uxga
帝乡明日到	uxjg
弟兄姐妹舞翩跹	ukvk
低眼佯行	whwt
第一花	tgaw
第一湘江雨	tgif
地应无酒泉	fyfr
地犹鄹氏邑	fqbk
堤远意相随	ffub
帝曰汝度功第一	ujig
笛在月明楼	tdes
笛中闻折柳	tkus
第中无一物	tkft
地主重重压迫	fytr
帝子乘风下翠微	ubtt
弟子服其劳	ubea
弟子韩干早入室	ubfp
弟子记之	ubyp
弟子入则孝	ubtf
弟子孰为好学	ubyi
笛奏龙吟水	tddi
滇池水	iiii
颠倒思予	fwlc
颠倒衣裳	fwyi
点点楼头细雨	hhsf
点点是	hhjg
颠而不扶	fdgr
簟翻寒江浪	ttpi
殿阁生微凉	nutu
点画信手烦推求	hgwf
典籍开书府	mtgy
点降唇	hbdf
颠连直接东溟	flfi
颠沛必于是	finj
殿前欢	nucq
钿头银篦击节碎	quqd
点溪荷叶叠青钱	hiaq
点樱桃	hssi
颠之倒之	fpwp
电子版说明	jbtj
钓罢归来不系船	qljt
吊白居易	krnj
凋此红芳年	uhxr
雕弓写明月	mxpe
吊古战场文	kdhy
调角断清秋	yqot
雕阑玉砌应犹在	mugd
吊罗荣桓同志	klaf
貂裘换酒	efri
雕声带晚悲	mfgd
吊严陵	kgbf
钓鱼闲处	qqut
蝶翻轻粉双飞	jtln
蝶恋花答李淑一	jyag
迭为宾主	rypy
蝶舞已无多	jrnq
鼎铛玉石	hqgd
丁丁漏水夜何长	ssit
定定住天涯	ppwi
丁督护歌	shrs
丁儿	sgqt
定风流	pmiy
丁亥岁云暮	syma
鼎湖流水清且闲	hiiu
定乎内外之分	ptmw
定计于鲜也	pygb
丁居晦	snjt
订了三家条约	ybdx
丁棱	sgsf
丁默	sglf
定如拱北极	pvrs
定僧	pgwu
定是风光牵宿醉	pjms
定水迥分晖	pimj
丁位	sgwu
丁谓	sgyl
定西番	psto
丁仙芝	swap
丁香结	stxf
丁香空结雨中愁	stpt
丁泽	sgic
定之方中	ppyk
丁注	sgiy
东壁图书府	anly
东船西舫悄无言	atsy
动刀甚微	fvat
董德元	atfq
侗而不愿	wdgd
东方白	ayrr
洞房洞房环佩冷	iyiu
东方风来满眼春	aymd
东方虬	ayjn
东方未明	ayfj
东方未晞	ayfj
东方欲晓	aywj
东方云海空复空	ayfp
东方之日	aypj
洞房昨夜春风起	iyjf
洞房昨夜停红烛	iyjo
东风不为吹愁去	amgf
东风吹水日衔山	amkm
东风寒	ampf
东风袅袅泛崇光	amqi
东风洒雨露	amif
东风送暖入屠苏	amua
东风随春归	ambj
东风未肯入东门	amfu
东风已绿瀛洲草	amna
东风知我欲山行	amtt
董夫子	afbb
东冈	aimq
东皋薄暮望	aray
东皋刈黍归	arqj
冬歌	tusk
东割膏腴之地	apyf
东归在洛阳	ajdb
东还海道	agiu
东海黄公	aiaw
洞壑当门前	ihiu
东湖月	aiee
东家老女嫁不售	apfw
东家有贤女	apdv
东郊	aiuq
冬尽今宵促	tnww
东京发使臣	ayna
东来紫气满函关	aghu
东林怀我师	asnj
东临碣石有遗篇	ajdt
董龙更是何鸡狗	adgq
东门酤酒饮我曹	ausg
东门之墠	aupf
东门之池	aupi
东门之枌	aups
东门之杨	aups
东面而视	addp
东坡七集	afaw
东坡题跋	afjk
冬青树上挂凌霄	tgsf
动取无妄疾	fbfu
东犬西吠	adsk
动人春色不须多	fwdq
冬日归旧山	tjjm
动如参与商	fvcu
东山高卧时起来	amyg
冻死苍蝇未足奇	ugad
董思恭	alaw
东台去	acfc
洞天石扇	igdy
洞庭波涌连天雪	iyif
洞庭春色	iydq
洞庭西望楚江分	iysw
洞庭一夜无穷雁	iygd
洞庭之东江水西	iyps
东望武昌	aygj
东望西望路迷	ayso
东武吟	agkw
董武子	agbb
东西道	asut
东西南北	asfu
动息如有情	ftvn
东西随势倾	asbw
东西跳梁	aski
东西消息稀	asit
东西值松柏	asws
东仙	aiwm
洞仙词	iwyn
东阳歌	absk
动摇风满怀	frmn
动摇山水影	frmj
冬夜夜寒觉夜长	tyyt
冬夜杂咏	tyvk
董乂	at
东园垂柳径	altt
东原乐	adqi
洞在清溪何处边	idil
动之不以礼	fpgp
动枝生乱影	fstj
冬之夜	tpyw
洞中开宴会	ikgw
洞中仙	ikwm
斗鹌鹑	udyb
斗百草	udaj
斗百花	udaw
窦参	pwcd
斗婵娟	uvvk
窦常	pwip
窦夫人	pfww
窦弘余	pxwt
窦冀	pwux
都镜净	fquq
斗酒十千恣欢谑	uify
窦蒙	pwap
窦牟	pwcr
窦群	pwvt
都是人间城郭	fjwy
窦叔向	phtm
窦威	pwdg
窦希玠	pqgw
窦庠	pwyu
豆叶黄	gkam
窦裕	pwpu
杜安道	sput
杜安世	span
读罢泪沾襟	ylip
独伴梨花影	qwtj
独步闲庭逐夜凉	qhuu
杜常	sfip
独成其天	qdag
独出冠时	qbpj
独旦	qtjg
杜东	sfai
杜羔	sfug
杜工部蜀中离席	sauy
渡海十年归	iifj
独鹤归何晚	qpjj
都护军书至	frpg
都护铁衣冷犹著	frqa
独见晓焉	qmjg
读尽床头几卷书	ynyn
独居三年	qndr
渡口水流宽	ikip
杜兰香去未移时	sutj
独乐其身	qqat
杜耒	sfdi
独立东风看牡丹	quam
独立寒秋	qupt
独立濛濛细雨中	quik
独立三边静	qudg
独立天地间	qugu
独立小楼风满袖	quip
独立扬新令	qurw
独怜京国人南窜	qnyp
杜良臣	syah
渡辽水	ibii
度岭方辞国	ymyl
杜陵有布衣	sbdy
独留青冢向黄昏	qqgq
独漉篇	qity
读陆游咏梅词	ybiy
独寐寤歌	qpps
独寐寤言	qppy
度门寺	yuff
渡陌临流不自持	ibjr
独敲初夜磬	qypf
杜秋娘	stvy
独上高楼望吴越	qhyf
独上洛阳桥	qhis
妒深情却疏	vinn
杜审言	spyy
赌胜马蹄下	mecg
读书贵能疑	ynkx
读书即未成名	ynvq
独树老夫家	qsfp
独戍临江夜泊船	qdjt
读书万卷不读律	yndt
读书万卷始通神	yndp
度水逢胡说	yity
独速短蓑舞	qgtr
独宿江城蜡炬残	qpig
独宿空帘归梦长	qppt
渡头馀落日	iuqj
独往独来	qtqg
读未见书	yfmn
杜韦娘	sfvy
独闻和焉	qutg
度我至军中	ytgk
独无外物牵	qfqd
独息	qtth
独向溪山廉	qtiy
独携天上小团月	qrge
笃信好学	twvi
杜荀鹤	sapw
杜俨	sfwg
杜淹	sfid
渡扬子江	irbi
独夜三更月	qyde
独夜忆秦关	qynu
杜奕	sfyo
杜易简	sjtu
独倚楼	qwso
独有凤凰池上客	qdmp
独有豪情	qdyn
独有宦游人	qdpw
独有南山桂花发	qdfn
独有英雄驱虎豹	qdae
杜宇	sfpg
杜于皇	sgrg
笃于时也	tgjb
杜元颖	sfxt
独照长门宫里人	qjtw
渡浙江问舟中人	iiiw
杜正伦	sgww
独自下寒烟	qtgo
独自倚阑干	qtwf
独自在家长似客	qtdp
独醉	qtsg
独坐池塘如虎踞	qwik
断肠春色在江南	oedf
段丞	wdbi
段成式	wdaa
短服改胡衣	teny
段谷	wdww
断碣残碑	odgd
断绝胡儿恋母声	oxdf
断头今日意如何	ouww
段文昌	wyjj
端午临中夏	utjd
断无消息石榴红	ofix
断弦离柱箭脱手	oxyr
断续寒砧断续风	oxpm
断雁警愁眠	odah
段倚	wdwd
短者不为不足	tfgk
断之则悲	opmd
对楚王问	csgu
对此间	chuj
对此结中肠	chxe
对此欲倒东南倾	chww
对敌慈悲对友刁	ctun
对酒不觉暝	cigj
对酒当歌歌不成	ciid
对酒行	citf
对酒卷帘邀明月	ciue
对客挥毫秦少游	cpri
堆来枕上愁何状	fgsu
对棋陪谢傅	csbw
对青山	cgmm
对雪二首	cffu
对玉环	cggg
敦煌曲子	yomb
顿使别离难	gwkc
顿失滔滔	grii
敦兮其若朴	ywas
多病故人疏	qudn
多藏必厚亡	qany
杕杜	sdsf
多见而识之	qmdp
夺锦标	dqsf
多愧鲁连生	qnqt
多丽	qqgm
多难识君迟	qcyn
多歧路今安在	qhkd
多情应笑	qnyt
多如牛毛	qvrt
多少长安名利客	qitp
夺席谈经非五鹿	dyyy
多谢后世人	qyrw
多于机上之工女	qgsv
多于九土之城郭	qgvy
多于南亩之农夫	qgff
多于市人之言语	qgyy
多于在庾之粟粒	qgdo
多于周身之帛缕	qgmx
恶不仁者	ggwf
恶称人之恶者	gtwf
恶乎成名	gtdq
恶勇而无礼者	gcdf
恶紫之夺朱也	ghpb
恩荣变苦辛	layu
尔爱其羊	qeau
二八泉扉掩	fwrr
尔辈苦无恃	qdan
而本无形	dsfg
而必为之辞	dnyt
尔卜尔筮	qhqt
而不见舆薪	dgma
耳不能两听而聪	bgcb
而不能至者	dgcf
二不孝也	fgfb
而不与立也	dggb
而不知其然	dgtq
而不知其所以然	dgtq
而不知其所止	dgth
而耻恶衣恶食者	dbgf
而耻学于师	dbij
二川溶溶	fkii
而待将军	dtup
耳得之而为声	btpf
二冬	fgtu
尔独如玉	qqvg
二更酒醒船初发	fgin
而贵食母	dkwx
而国危矣	dlqc
而后和之	drtp
而后乃今将图南	dref
而后乃今培风	drem
而后人毁之	drwp
而记游者甚众	dyiw
而见者远	dmff
而今迈步从头越	dwdf
而今我谓昆仑	dwtw
而绝江河	dxii
而可大受也	dsdb
而况精神	duop
而况人乎	duwt
而况我乎	dutt
而况于明哲乎	dugt
而况于人乎	dugt
尔来四万八千岁	qglm
二陵风雨自东来	fbmg
而刘夙婴疾病	dymu
而乱臣贼子惧	dtan
而乱大伦	dtdw
而美之者	dupf
而民不争	dngq
而民弥贫	dnxw
而民乃始	dnev
而民自富	dntp
而民自化	dntw
而民自朴	dnts
而民自正	dntg
而母立于兹	dxuu
尔鸟	qiqy
儿女忽成行	qvqt
儿女罗酒浆	qvlu
而气候不齐	drwy
而其见愈奇	damd
而人居其一焉	dwng
而人死亦次之	dwgp
而人之所罕至焉	dwpg
二三其德	fdat
二色莲	fqal
而神明自得	dpjt
二十八宿罗心胸	ffwe
二十时	ffjf
二十四日	fflj
二十万军重入赣	ffdu
二十五径	ffgt
二十一个	ffgw
二十有八载	ffdf
而世之奇伟	dapw
而庶几乎	dymt
而谁以易之	dynp
二水中分白鹭洲	fiki
二宋	fgps
尔所不知	qrgt
尔所谓达者	qryf
而所欲问者	drwf
二桃杀三士	fsqf
而天下平	dggg
而听	dmkr
而听细说	dkxy
儿童强不睡	quxh
而万物与我为一	ddtg
而往拜之	dtrp
而往来者	dtgf
而王先生	dgtt
而望幸焉	dyfg
而未尝往也	dfib
而闻者彰	dufu
而我独若遗	dtqk
而无不在也	dfgb
耳无所闻	bfru
而无望兮	dfyw
二萧	fgav
儿已薄禄相	qnas
而亦何常师之有	dywd
而以身轻天下	dntg
而用之或不盈	depe
而又不随以怠	dcgc
而又害之	dcpp
而又何羡乎	dcwt
而游乎四海之外	ditq
而犹浸灌	dqii
而由人乎哉	dmwf
而有斯疾也	ddab
而有宋朝之美	ddpu
而有天下	ddgg
二与一为三	fggd
而愚之始	djpv
二月垂杨未挂丝	fetx
二月二日江上行	feft
二月二十二	feff
二月湖水清	feii
二月黄鹂飞上林	feas
而在己为有悔	ddnn
而在萧墙之内也	ddab
而之楚游者	dpsf
而致千里	dgtj
迩之事父	qpgw
二肿	fgek
而众星共之	dwjp
耳著明月璫	bajg
二子乘舟	fbtt
而子证之	dbyp
而卒莫消长也	dyab
而卒葬之	dyap
发白马	nrcn
发而不中	ndgk
发愤忘食	nnyw
伐鼓渊渊	wfii
发皓齿	nrhw
发乎天光	ntgi
伐柯	wass
伐柯伐柯	wsws
伐柯如何	wsvw
伐木丁丁	wsss
伐木许许	wsyy
发人深省	nwii
伐树于宋	wsgp
发我枝上花	ntsa
发言盈庭	nyey
法语之言	iypy
泛爱众而亲仁	ieww
凡百君子	mdvb
凡百三十篇	mddt
凡百元首	mdfu
泛彼柏舟	itst
范朝	aifj
樊忱	sqnp
樊迟问仁	snuw
樊迟问知	snut
范传正	awgh
范灯	aios
翻动扶摇羊角	tfrq
犯而不校	qdgs
反而求之	rdfp
泛泛其景	iiaj
泛泛其逝	iiar
泛泛入烟雾	iitf
范飞	ainu
樊夫人	sfww
反复终始	rtxv
犯孤平	qbgu
帆过浪无痕	mfiu
反乎尔者也	rtqb
犯花	qtaw
繁华事散逐香尘	twgi
凡今之人	mwpw
烦君最相警	ovja
烦疴近消散	oura
翻空白鸟时时见	tprm
樊哙从良坐	skww
泛兰舟	iute
翻浪惊飞鸟	tinq
凡六百一十六言	mudy
范梦龙	asdx
凡民有丧	mndf
蕃女怨	avqb
繁钦	txqq
翻身向天仰射云	tttf
反是不思	rjgl
反是生女好	rjtv
反是者败	rjfm
翻手覆手不可期	trsa
翻手作云覆手雨	trwf
凡外重者内拙	mqtr
凡物各自有根本	mtts
凡物无成与毁	mtfv
翻香令	ttwy
繁星宿故关	tjpu
樊珣	sqgq
范炎	aioo
范夜	aiyw
翻疑梦里逢	txst
翻与扇俱团	tgyl
范元凯	afmn
翻云覆雨等闲间	tfsu
凡再变矣	mgyc
凡在故老	mddf
范增数目项王	afog
反者道之动	rfuf
繁枝容易纷纷落	tspa
范周	aimf
樊宗师	spjg
范祖禹	aptk
房白	ynrr
方不可方可	ygss
芳草	ayaj
芳草年年与恨长	aart
芳草已云暮	aana
方存乎见少	ydti
放荡齐赵间	yayu
防范胜于救灾	baep
芳菲君不见	aavm
方干	yyfg
房琯	yngp
方衡	yytq
放乎四海	ytli
方涣涣兮	yiiw
方今之时	ywpj
访旧半为鬼	yhur
方可方不可	ysys
方里而井	yjdf
方六七十	yuaf
防露	byfk
放马天山雪中草	ycga
放辟邪侈	ynaw
方其梦也	yasb
方七十里	yafj
方千里	ytjf
房融	yngk
房孺复	ybtj
方如行义	yvty
放生鱼鳖逐人来	ytqg
芳树	aysc
芳树笼秦栈	asts
方死方生	ygyt
方显出英雄本色	yjbq
芳心向春尽	antn
防有鹊巢	bdav
方愚	yyjm
放于利而行	ygtt
方宅十余亩	ypfy
方知大蕃地	ytdf
方之舟之	yptp
方资	yyuq
匪报也	arbn
非彼无我	dtft
非不能也	dgcb
非不说子之道	dgyu
非常之观	dipc
飞沉理自隔	nigb
非崇德与	dmtg
非大愚也	ddjb
非道也哉	dubf
废嫡立庶	yvuy
非尔所及也	dqrb
匪风	admq
匪斧不克	awgd
非敢为佞也	dnyb
非关癖爱轻模样	duus
飞花搅独愁	nart
飞花两岸照船红	nagx
飞花满四邻	naiw
非及向时之士也	detb
飞剑决浮云	nwuf
飞将军自重霄入	nupt
非君子也	dvbb
飞来飞来	ngng
飞来飞去落谁家	ngnp
飞来峰	ngmt
匪来贸丝	agqx
非醴泉不饮	dsrq
非礼之礼	dppp
非利足也	dtkb
非练实不食	dxpw
匪媒不得	avgt
飞鸣镝	nkqu
飞鸣声念群	nkfv
肥男有母送	eldu
非能水也	dcib
飞鸟没何处	nqit
飞鸟千里不敢来	nqtg
匪女之为美	avpu
飞蓬各自远	natf
妃嫔媵嫱	vvev
非其鬼而祭之	darp
飞起玉龙三百万	nfgd
非其罪也	dalb
非求益者也	dfub
飞泉挂碧峰	nrrm
斐然成章	dqdu
非人磨墨墨磨人	dwyw
非人之所能为也	dwpb
飞沈理自隔	nigb
非世之人	dapw
肥水之战	eiph
非天下也	dggb
非徒无形也	dtfb
非徒无益	dtfu
飞湍瀑流争喧豗	niig
非谓其闻彼也	dyab
非谓文墨	dyyl
非为织作迟	dyxn
匪我愆期	atta
匪我思且	atle
非我无所取	dtfb
非无江海志	dfif
非梧桐不止	dssh
非吾徒也	dgtb
非先王之道	dtgu
非心服也	dneb
非行仁义也	dtwb
飞絮飞花何处是	nvnj
飞絮落花	nvaa
飞雪	nufv
飞雪带春风	nfgm
飞雪满群山	nfim
飞雪似杨花	nfwa
非言非默	dydl
飞燕皇后轻身舞	narr
飞扬跋扈为谁雄	nrkd
非以明民	dnjn
非以鸟养养鸟也	dnqb
非以其无私邪	dnaa
非义之义	dypy
非阴非阳	dbdb
非有仲尼	ddwn
非曰能之	djcp
飞月向南端	netu
飞在白云端	ndru
妃之	vnpp
非至强之人	dgxw
非助我者也	detb
焚百家之言	sdpy
分曹限紫微	wgbt
粉蝶儿慢	ojqn
纷纷泊泊夜飞鸦	xxia
纷纷开且落	xxga
纷纷轻薄何须数	xxlo
纷纷扰扰十年间	xxru
纷纷射杀五单于	xxtg
焚椒兰也	ssub
汾沮洳	iiiv
分裂山河	wgmi
奋六世之余烈	duag
分流水	wiii
焚驴志	scfn
分明怨恨曲中论	wjqy
分明在眼前	wjdu
分明照	wjjv
坟墓在万里	fadj
纷墙丹柱动光彩	xfme
焚烧杀掠	soqr
分身千百亿	wttw
分手脱相赠	wrem
汾水之阳	iipb
分司东都	wnaf
分田分地真忙	wlwn
粪土当年万户侯	ofiw
分外妖娆	wqvv
分我一杯羹	wtgu
分野中峰变	wjky
焚之已成灰	spnd
封敖	ffgq
封闭宫室	fupp
逢彼之怒	ttpv
风波不信菱枝弱	migx
逢场作戏三昧俱	tfww
凤巢西隔九重门	mvsu
风尘何处期	miwa
风尘何所期	miwa
风尘荏苒音书绝	miax
风尘三尺剑	midw
凤城寒尽怕春宵	mfpp
凤城何处有花枝	mfws
凤池吟	mikw
风船解与月徘徊	mtqt
风吹柳花满店香	mkst
凤吹声如隔彩霞	mkff
风吹细细香	mkxt
风吹仙袂飘飘举	mkwi
风吹雨	mkfg
讽刺诗	ygyf
奉答固道	dtlu
风灯照夜欲三更	mojg
蜂蝶纷纷过墙去	jjxf
风蝶令	mjwy
风多响易沉	mqki
凤飞九千仞	mnvw
风赋	mqmg
丰干	dhfg
风高大夫树	myds
凤歌笑孔丘	mstr
风骨超常伦	mmfw
凤孤飞	mbnu
风光好	mivb
风归云	mjfc
冯衮	ucuc
风乎舞雩	mtrf
风华正茂	mwga
凤凰池对青琐门	mmiu
凤凰初下紫泥诏	mmpy
凤凰和鸣	mmtk
凤凰间	mmuj
凤凰曲	mmma
凤凰山上雨初晴	mmmj
凤凰台上凤凰游	mmci
冯晖	ucjp
烽火被冈峦	oopy
烽火城西百尺楼	oofs
封寄泪空潸	fpii
风兼残雪起	mugf
风将衡桂接	mutr
风劲角弓鸣	mcqk
风景这边独好	mjyv
冯涓	ucik
风卷红旗过大关	muxu
冯伉	ucwy
凤来朝	mgfj
风来花自舞	mgar
丰乐楼	dqso
风雷动	mffc
锋棱瘦骨成	qsud
风帘残烛隔霜清	mpgi
风流才子多春思	mifl
风流贵公子	mikb
风流肯落他人后	mihr
风流儒雅亦吾师	miwj
风流扫地尽	mirn
风流少年时	miij
风流天下闻	migu
凤楼春	msdw
凤楼吟	mskw
风露透窗纱	mftx
枫落吴江冷	saku
风马儿	mcqt
风鸣静夜琴	mkgg
风鸣两岸叶	mkgk
丰年瑞	drgm
凤鸟不至	mqgg
风飘素影寒	msgp
风飘万点正愁人	msdw
风其吹女	makv
风凄凄	muug
凤栖梧	mssg
风樯动	msfc
风轻花自落	mlaa
风清露白	mifr
风清晓漏闻	miju
凤求凰	mfmr
冯去非	ufdj
凤去台空江自流	mfci
风泉满清听	mrik
风入罗衣贴体寒	mtlp
风入四蹄轻	mtll
风生云起	mtff
封书	ffnn
风霜其奈何	mfaw
风送宫嫔笑语和	mupt
冯宿	ucpw
凤台曲	mcma
凤吐流苏带晚霞	mkif
风为裳	myip
凤尾香罗薄几重	mntt
风物凄凄宿雨收	mtun
风物岂无情	mtmn
缝舞衣	xrye
凤兮凤兮非无凰	mwmm
凤栖梧桐	msss
凤仙引	mwxh
风萧萧兮转清	maai
凤萧吟	makw
冯涯	ucid
风压轻云贴水飞	mdln
风烟滚滚来天半	moiu
枫叶荻花秋瑟瑟	skag
枫叶落	skai
枫叶落纷纷	skax
冯应瑞	uygm
风雨	mqfg
风雨各自异	mftn
风雨凄凄	mfuu
风雨如晦	mfvj
风雨潇潇	mfii
风雨兴焉	mfig
风雨攸除	mfwb
风月相知	mest
风云常为护储胥	mfin
风云四海生	mflt
风云突变	mfpy
风展红旗如画	mnxg
风之积也不厚	mptd
风枝惊暗鹊	msna
风中柳	mksq
奉帚平明金殿开	dvgg
冯著	ucaf
夫哀莫大于心死	fyag
伏波惟愿裹尸还	wing
夫不自见而见彼	fgtt
抚长剑	rtwg
扶持自是神明力	rrtl
附词一首	bygu
夫大块载我以形	fdfg
夫达也者	fdbf
复道行空	tutp
复道交窗作合欢	tuuc
复道殊方礼	tugp
赋得浣纱石	mtid
赋得暮雨送李胄	mtam
赋得沙际路	mtik
赴敌甘负戈	ftaa
夫读书诗	fyny
富而好礼者也	pdvb
富而可求也	pdsb
富而无骄易	pdfj
扶风豪士歌	rmys
夫妇有别	fvdk
弗鼓弗考	xfxf
妇姑相唤浴蚕去	vvsf
富贵必从勤苦得	pknt
富贵不相忘	pkgy
浮桂动丹芳	isfa
复归其明	tjaj
复归于朴	tjgs
复归于物	tjgt
复归于无极	tjgs
复归于婴儿	tjgq
夫何为哉	fwyf
夫何忧何惧	fwnn
夫何远之有	fwfd
夫环而攻之	fgdp
抚剑夜吟啸	rwyk
抚剑增感慨	rwfn
夫将不欲	fugw
斧斤以时入山林	wrns
府吏得闻之	ygtp
府吏见丁宁	ygmp
府吏马在前	ygcu
府吏闻此变	yguy
府吏闻此事	ygug
赋料扬雄敌	mort
夫列子御风而行	fgbt
复令识者久叹嗟	twyk
福履成之	pndp
福履将之	pnup
福履绥之	pnxp
福马郎	pcyv
赋梅	mgst
赴密州	fpyt
复命曰常	twji
福莫长于无祸	patp
父母生我	wxtt
父母之年	wxpr
父母之心	wxpn
负你残春泪几行	qwgt
拂霓裳	rfip
抚念益慈柔	rwuc
妇女解放	vvqy
妇女无所幸	vvff
富平少侯	pgiw
夫千里之远	ftjf
富且贵焉	pekg
福轻乎羽	pltn
夫轻诺必寡信	flyw
夫然后行	fqrt
夫人不言	fwgy
妇人见之	vwmp
妇人在军中	vwdk
芙蓉不及美人妆	aagu
芙蓉国里尽朝晖	aalj
芙蓉曲	aama
芙蓉塘外有轻雷	aaff
芙蓉向脸两边开	aatg
芙蓉月	aaee
夫三年之丧	fdrf
扶桑已成薪	rcna
浮生共憔悴	itan
浮生聚散云相似	itbw
浮生恰似冰底水	itni
浮生如梦能几何	itvw
浮世本来多聚散	iasa
父师检责惊走书	wjsn
抚事慷慨	rgnn
伏尸数万	wnod
复守其母	tpax
肤受之诉	eepy
妇叹于室	vkgp
甫田	gell
浮天沧海远	igif
俯听闻惊风	wkum
复通为一	tcyg
复往邀之	ttrp
夫妄意室中之藏	fyua
夫唯不可识	fkgy
夫唯不盈	fkge
夫唯灵修之故也	fkvb
伏惟启阿母	wnyx
伏惟圣朝	wncf
夫为天下者	fygf
父为子隐	wybb
夫闻也者	fubf
夫我乃行之	ftep
夫我则不暇	ftmj
复我诸兄	ttyk
复无极也	tfsb
夫物芸芸	ftaa
父兮生我	wwtt
浮想联翩	isby
浮香绕曲岸	itxm
夫婿轻薄儿	fvlq
覆压三百余里	sddj
夫言非吹也	fydb
俯仰人间今古	wwwd
俯仰天地间	wwgu
俯仰昔人非	wwad
芣苡	agan
复忆襄阳孟浩然	tnyq
俯饮一杯酒	wqgi
腹犹果然	eqjq
浮游乎万物之祖	iitp
蜉蝣掘阅	jjru
蜉蝣之翼	jjpn
蜉蝣之羽	jjpn
父曰	wqjh
浮云不共此山齐	ifgy
浮云连海岱	iflw
浮云一别后	ifgr
浮云终日行	ifxt
符载	twfa
覆载天地	sfgf
覆载万物者也	sfdb
富哉言乎	pfyt
复值接舆醉	twrs
夫埴木之性	ffsn
夫至人者	fgwf
夫知亦有之	ftyp
腹中无一物	ekft
腹中贮书一万卷	ekmu
服周之冕	empj
夫子奔逸绝尘	fbdi
夫子步亦步	fbhh
傅自得	wttj
夫子何哂由也	fbwb
夫子何为者	fbwf
夫子加齐之卿相	fbls
夫子喟然叹曰	fbkj
夫子趋亦趋	fbff
夫子哂之	fbkp
夫子圣者与	fbcg
父子相亲	wbsu
夫子焉不学	fbgi
夫子言之	fbyp
夫子欲之	fbwp
夫子之不可及也	fbpb
夫子之道	fbpu
夫子之得邦家者	fbpf
夫子之墙数仞	fbpw
夫子之谓也	fbpb
夫子之文章	fbpu
夫子至于是邦也	fbgb
夫子之云	fbpf
夫子自道也	fbtb
俯足以畜妻子	wknb
改革内政	namg
盖均无贫	uffw
盖其又深	uaci
盖阙如也	uuvb
盖十世希不失矣	ufac
盖闻善摄生者	uuuf
改邑不改名	nkgq
盖亦反其本矣	uyrc
盖亦勿思	uyql
盖音谬也	uuyb
盖有之矣	udpc
盖余所至	uwrg
改之为贵	npyk
盖竹柏影也	utsb
甘草子	aabb
感此怀故人	dhnw
感此伤妾心	dhwn
感恩多	dlqq
感而后应	ddry
敢告云山从此始	ntfv
干戈犹未定	faqp
干荷叶	fakf
赣江风雪迷漫处	uimt
敢将十指夸针巧	nufa
敢教日月换新天	nfjg
感君恩重许君命	dvlw
感君区区怀	dvan
甘苦与共	aaga
干旄	fgyt
感梦	dgss
感时抚事增惋伤	djrw
感时思报国	djll
赣水苍茫闽山碧	uiag
赣水那边红一角	uivq
感斯人言	dawy
敢问何故	nuwd
敢问何谓也	nuwb
敢问其次	nuau
甘心首疾	anuu
敢用玄牡	neyt
感遇四首	djlu
感遇四首之二	djlf
感遇四首之三	djld
感遇四首之四	djll
感遇四首之一	djlg
感征戍之事	dtdg
甘州遍	ayyn
甘州歌	aysk
甘州令	aywy
甘州曲	ayma
甘州子	aybb
感子故意长	dbdt
刚道有雌雄	mudd
刚健含婀娜	mwwv
刚毅木讷	musy
高才何得混妍媸	yfwv
高才脱略名与利	yfet
高蟾	ymjq
高崇文	ymyy
高第后归道	ytru
高低冥迷	ywpo
高低顺过风	ywkm
高帝子孙尽隆准	yubu
高风汉阳渡	ymii
告夫三子	tfdb
杲杲出日	jjbj
高高正北飞	yygn
高阁高阁	yuyu
高阁客竟去	yupf
高歌取醉欲自慰	ysbn
告归常局促	tjiw
高乎视低	ytpw
高怀见物理	ynmg
高节人相重	yawt
高句骊	yqcg
高楼当此夜	ysiy
高楼风雨感斯文	ysmy
高路入云端	yktu
高论怨诽	yyqy
高明逼神恶	yjgg
高辇	ymfw
高峤	ymmt
羔裘	ugfi
高丘怀宋玉	yrng
羔裘逍遥	ufie
高衢	ymth
高山安可仰	ympw
高山流水	ymii
高绍	ymxv
高适	ymtd
高树晓还密	ysjp
高树早凉归	ysjj
缟素漠漠开风沙	xgii
高堂明镜悲白发	yijn
高蹄战马三千匹	ykha
高天滚滚寒流急	ygiq
高卧南斋时	yafj
高峡出平湖	ymbi
高下相盈	ygse
高下与云平	yggg
槁项黄馘	saau
缟衣綦巾	xyam
高以下为基	ynga
高者十八九	yffv
高拯	ymrb
高正臣	ygah
高铢	ymqr
告诸往而知来者	tytf
高子芳	ybay
告子未尝知义	tbfy
高宗谅阴	ypyb
戈壁舟	ante
歌吹是扬州	skjy
各党各界	titl
阁道二神过	uuff
阁道回看上苑花	uula
各复归其根	ttjs
各复其根	ttas
各各还家门	ttgu
歌管风轻度	stmy
隔户杨柳弱袅袅	bysq
戈挥日回	arjl
葛屦	ajnt
葛藟	ajal
葛藟荒之	aaap
隔篱呼取尽馀杯	btks
隔篱娇语络丝娘	btvv
隔离天日	bygj
隔帘听	bpkr
歌令	skwy
个侬	whwp
隔浦莲近拍	biar
隔墙如隔山	bfvm
歌且谣	seye
葛覃	ajsj
歌曲动寒川	smfk
隔山望南斗	bmyu
葛生	ajtg
歌声唱彻月儿圆	sfkl
葛胜仲	aewk
葛氏女	aqvv
哥舒歌	swsk
哥舒夜带刀	swyv
隔水问樵夫	biuf
歌未竟	sfuj
歌舞入长安	srtp
隔溪梅令	bisw
隔溪猿哭瘴溪藤	biqa
葛鸦儿	aaqt
歌窈窕之章	sppu
阁夜	utyw
歌一曲	sgma
歌以赠之	snmp
各有稻粱谋	tdty
歌有声	sdfn
各于其党	tgai
各在天一方	tdgy
各在一处	tdgt
葛之覃兮	apsw
阁中帝子今何在	ukud
各自东西流	ttai
各自双双	ttcc
更持红烛赏残花	grxa
更复何忧	gtwn
更隔蓬山一万重	gbat
耿耿不寐	bbgp
更加郁郁葱葱	glda
更加众志成城	glwf
更教明月照流黄	gfja
更结人间未了因	gxwl
更堪江上鼓鼙声	gfif
更看金谷骑	grqc
更立西江石壁	gusn
更漏促春宵	giwp
更那堪凄然相向	gvft
更请君王猎一围	gyvl
更上一重楼	ghgs
更稍强者	gtxf
耿湋	boin
耿玮	bogf
耿纬	boxf
更闻桑田变成海	guci
更无豪杰怕熊罴	gfyl
更无人处帘垂地	gfwf
更喜岷山千里雪	gfmf
更相为命	gsyw
哽咽不能语	kkgy
更有潺潺流水	gdii
更有明朝恨	gdjn
耕者枪然得其间	dfsu
更值夜萤飞	gwyn
耕种从此起	dtwf
更作风檐夜雨声	gwmf
弓背霞明剑照霜	xuff
宫车过也	plfb
功成不退皆殒身	adgt
功成而不居	addn
功成而不有	addd
功成拂衣去	adrf
公乘亿	wtwn
宫词	pkyn
共此灯烛光	ahoi
公从何处得纸本	wwws
公等在	wtdh
共滴长门一夜长	aitt
恭而无礼则劳	adfa
共分一日光	awgi
公服贵貂蝉	wekj
功盖三分国	audl
宫馆何玲珑	pqwg
公贵干蛊高巾冠	wkfp
公侯之事	wwpg
宫花寂寞红	papx
公见人被暴害	wmwp
恭俭推让	awry
恭近于礼	argp
共君此夜须沉醉	avhs
共看明月皆如此	arjh
恭宽信敏惠	apwg
共来百越文身地	agdf
共怜时世俭梳妆	anju
功名富贵两蜗角	aqpq
功名富贵若长在	aqpd
功名万里外	aqdq
功名夏后商周	aqdm
功名只向马上取	aqkb
宫女如花满春殿	pvvn
宫嫔	pkvp
躬亲抚养	turu
攻亲戚之所畔	audl
共赏一轮明月	aige
共说此年丰	ayhd
公私仓廪俱丰实	wtwp
弓嗣初	xkpu
公孙丑上	wbnh
公孙丑下	wbng
公孙剑器初第一	wbwg
公孙龙口	wbdk
公为我献之	wytp
公无渡河	wfii
公西华曰	wswj
躬行君子	ttvb
公冶长第五	wutg
功业相反也	aosb
宫衣亦有名	pyyq
共迎中使望乡台	aqkc
共有樽中好	adsv
共约重芳日	axtj
恭则不侮	amgw
宫中调笑	pkyt
公主琵琶幽怨多	wygq
躬自悼矣	ttnc
公子南桥应尽兴	wbfi
公子王孙芳树下	wbgg
共醉重阳节	asta
共作游冶盘	awit
狗不以善吠为良	qgny
狗吠深巷中	qkik
苟非吾之所有	adgd
苟患失之	akrp
苟能制侵陵	acrb
苟无恒心	afnn
苟无饥渴	afqi
钩心斗角	qnuq
沟引新流几曲声	ixuf
苟有用我者	adef
构造出了	stbb
苟正其身矣	agac
苟志于仁矣	afgc
苟子之不欲	abpw
古柏行	dstf
孤壁野僧邻	bnjw
故别	dtkl
故不登高山	dgwm
故不积跬步	dgth
谷不可胜食也	wgsb
固不如也	lgvb
故不为也	dgyb
固不知子矣	lgtc
孤臣霜发三千丈	bafd
孤城背岭寒吹角	bfuq
孤城当落晖	bfij
孤城落日斗兵稀	bfat
古城旁	dfup
孤城山谷间	bfmu
古祠高树两茫然	dpyq
古从军行	dwpt
古道连绵走西京	duly
孤灯不明思欲绝	bogx
孤灯寒照雨	bopf
孤灯未灭梦难成	bofd
孤灯闻楚角	bouq
鼓笛慢	ftnj
古调虽自爱	dyke
故多能鄙事	dqcg
固而近于费	ldrx
顾非熊	ddce
孤飞一片雪	bngf
孤飞自可疑	bntx
孤愤	brnf
鼓峰	fkmt
孤凤竟不至	bmug
故夫知效一官	dftp
孤高几百寻	bymv
孤高耸天宫	bywp
孤馆灯青	bqog
故关衰草遍	duyy
故贵以身为天下	dkng
故国平居有所思	dlgl
故国三千里	dldj
孤鸿海上来	biig
孤鸿既高举	bivi
故混而为一	didg
孤魂久客间	bfqu
古记	dgyn
古今词话	dwyy
古今来许多世家	dwgp
古今一体	dwgw
故旧不遗	dhgk
沽酒市脯不食	iiyw
故九万里	dvdj
沽酒与何人	iigw
古决绝词	duxy
故君子有不战	dvbh
估客乐	wpqi
估客昼眠知浪静	wpng
谷口春残黄鸟稀	wkdt
顾况	dbuk
古来白骨无人收	dgrn
古来材大难为用	dgse
古来存老马	dgdc
古来得意不相负	dgtq
古来青史谁不见	dggm
古来圣贤皆寂寞	dgcp
古来万事东流水	dgdi
孤兰生幽园	butl
故垒西边人道是	dcsj
孤鸾	bryo
沽美酒	iuis
古庙杉松巢水鹤	dysp
故民之从之也轻	dnpl
故木受绳则直	dsef
钴鉧潭记	qqiy
钴鉧潭西小丘记	qqiy
古木无人径	dsft
故能长生	dctt
故能成器长	dcdt
故能为百谷王	dcyg
谷鸟惊棋响	wqnk
谷鸟一声幽	wqgx
顾盼自雄	dhtd
孤平	brgu
故遣将守关者	dkuf
故遣来贵门	dkgu
故强为之容	dxyp
孤琴候萝径	bgwt
古倾杯	dwsg
故去彼取此	dfth
故群于人	dvgw
故绕池边树	dxis
故人不见	dwgm
故人不用赋招魂	dwgf
故人重分携	dwtr
故人家在桃花岸	dwpm
故人江海别	dwik
古人今人若流水	dwwi
故人入我梦	dwts
故人殊未来	dwgg
古人无复洛城东	dwfa
故人相逢耐醉倒	dwsw
古人有之	dwdp
古人之观於天地	dwpf
骨弱筋柔而握固	mxtl
固若是芒乎	lajt
鼓瑟鼓琴	fgfg
故善人者	duwf
孤山寺	bmff
古社	dgpy
谷神不死	wpgg
故圣人云	dcwf
故声闻过情	dfun
故失道而后德	drut
故是非不得于身	djdt
顾视无可置者	dpff
谷食之所生	wwpt
古戍	dgdy
古戍苍苍烽火寒	ddap
古树倒江横	dsws
故述往事	dstg
故说诗者	dyyf
姑苏台上乌栖时	vacj
姑苏台上宴吴王	vacg
故岁今宵尽	dmwn
古台摇落后	dcrr
古调笑	dytt
故往见之	dtmp
古往今来只如此	dtwh
故王之不王	dgpg
故为天下贵	dygk
顾我复我	dttt
顾我无衣搜荩箧	dtft
顾我则笑	dtmt
故无弃人	dfyw
故无弃物	dfyt
谷无以盈	wfne
故乡不可见	dxgm
故乡今夜思千里	dxwj
故乡无此好湖山	dxfm
故幸来告良	dfgy
顾夐	dbqm
孤雁不饮啄	bdgk
孤雁儿	bdqt
古阳关	dbud
故以身观身	dntt
固一世之雄也	lgab
顾影无如白发何	djfw
故有之以为利	ddpt
汩余若将不及兮	iwaw
故寓诸无竟	dpyu
故远人不服	dfwe
故园三十二年前	dldu
故园芜已平	dlag
故园杨柳今摇落	dlsa
孤月沧浪河汉清	beii
孤云将野鹤	bfup
觚哉觚哉	qfqf
顾朝阳	dfbj
古者民有三疾	dfnu
古者世称大手笔	dfat
古者言之不出	dfyb
古之道也	dpub
古之善为道者	dpuf
古之伤心人	dpww
古之所谓	dpry
古之贤人也	dpjb
古之学者必有师	dpij
古之学者为己	dpin
古之愚也直	dpjf
古之真人	dpfw
古之至人	dpgw
故知足之足	dtkk
固众芳之所在	lwad
故终无难矣	dxfc
孤舟一系故园心	btgn
孤烛异乡人	bonw
故作不良计	dwgy
故作此词	dwhy
寡不道以欢成	pgud
寡妇起彷徨	pvft
瓜茉莉	raat
寡人读书	pwyn
寡人好货	pwvw
寡人好色	pwvq
寡人愿安承教	pwdf
寡人之民不加多	pwpq
寡人之于国也	pwpb
寡人之於国也	pwpb
瓜熟子离离	ryby
挂席几千里	rymj
怪力乱神	nltp
观巴黎油画记	ccty
关城树色催寒近	ufsr
官非督护贵	pdhk
冠盖非新里	pudj
冠盖何辉赫	puwf
冠盖满京华	puiw
官高何足论	pywy
管鉴	tpjt
关雎之乱	uept
管领春风总不如	twdv
关门令尹谁能识	uuwy
关内阻饥	umbq
关盼盼	uhhw
观其眸子	cahb
管却自家身与心	tftn
关塞萧条行路难	upac
关山阵阵苍	umba
官事不摄	pggr
管氏而知礼	tqdp
惯弹琵琶解歌舞	nxgr
观天地生物气象	cgfq
管弦呕哑	txkk
官因老病休	plfw
观音妙智力	cuvl
官应老病休	pyfw
关咏	udky
观于大海	cgdi
观鱼胜过富春江	cqei
关月冷相随	ueub
管乐有才原不忝	tqdg
关张无命欲何如	uxfv
观者如山色沮丧	cfvf
冠者五六人	pfgw
官至礼部尚书	pgpn
官知止而神欲行	ptht
管仲不死	twgg
关中昔丧乱	ukat
管仲相桓公	twsw
管仲有病	twdu
管仲之力也	twpb
光被遐荒	ipna
光彩露沾湿	iefi
广昌路上	yjkh
广成子曰	ydbj
广德若不足	ytak
光而不耀	idgi
广寒秋	ypto
广寒枝	ypsf
广乎其似世也	ytab
光景不待人	ijgw
光禄池台开锦绣	ipix
广莫之野	yapj
光阴迫	ibrp
广泽生明月	yite
光照手	ijrt
归鞍竞带青丝笼	jaut
归朝欢	jfcq
贵大患若身	kdkt
归登	jvwg
桂殿秋	snto
桂殿入西秦	sntd
归飞体更轻	jnwl
归飞哑哑枝上啼	jnkk
桧风	swmq
归根曰静	jsjg
归国谣	jlye
归国遥	jler
归酣歌大风	jssm
归化	jvwx
桂华明	swje
桂华秋皎洁	swti
归客千里至	jptg
归孔子豚	jbbe
归来饱饭黄昏后	jgqr
贵来方悟稀	kgyt
归来归去来	jgjg
归来看取明镜前	jgru
归来每日斜	jgtw
归来且闭关	jgeu
归来视幼女	jgpv
归来头白还戍边	jgul
归来无人识	jgfy
归来已不见	jgnm
归来展转到五更	jgng
归来煮白石	jgfd
归老江湖边	jfil
桂林风景异	ssmn
归路满尘埃	jkif
归路晚风清	jkji
归马识残旗	jcyy
癸卯岁	wqmq
归梦不宜秋	jsgt
归梦隔狼河	jsbi
桂魄初生秋露微	srpt
归去难	jfcw
归去越王家	jffp
归塞北	jpux
鬼三台	rdck
归山深浅去	jmif
龟蛇静	qjge
龟蛇锁大江	qjqi
跪双膝	kces
归思欲沾巾	jlwm
归嵩山作	jmmw
贵为天子	kygb
归卧南山陲	jafb
鬼物守护烦撝呵	rtpk
归兮归兮	jwjw
归心折大刀	jnrv
归休乎君	jwtv
桂叶双眉久不描	skcr
桂影斑驳	sjgc
龟玉毁于椟中	qgvk
归于其居	jgan
归于其室	jgap
闺怨	ufqb
归哉归哉	jfjf
归棹洛阳人	jsiw
桂棹兮兰桨	sswu
闺中少妇不曾愁	ukit
闺中少妇不知愁	ukit
闺中只独看	ukkr
归字谣	jpye
归自谣	jtye
桂子月中落	sbea
滚绣球	ixgf
衮衣绣裳	uyxi
国必自伐	lntw
果不如先愿	jgvd
国朝盛文章	lfdu
国耻未雪	lbff
国初以来画鞍马	lpnc
过崔八丈水亭	fmwy
郭澹	ybiq
过而不改	fdgn
果而勿骄	jdqc
国风	lgmq
郭恭	ybaw
虢国夫人承主恩	elfl
国际悲歌歌一曲	lbdm
国家成败吾岂敢	lpdn
国家昏乱	lpqt
国家无事	lpfg
国家滋昏	lpiq
过江龙	fidx
过晋阳宫	fgbp
过了黄洋界	fbal
过骊山作	fcmw
郭利贞	ythm
郭良骥	yycu
过龙门	fduy
蜾蠃负之	jyqp
郭门临渡头	yuju
过蒙拔擢	farr
过七里滩	faji
过前后厅	furd
过勤政楼	fags
郭求	ybfi
过去已过去	ffnf
国人皆曰可杀	lwxq
过沙溪急	fiiq
郭绍兰	yxuf
郭受	ybep
过四皓墓	flra
过温汤	fiin
郭向	ybtm
过香积寺	fttf
国学生	litg
过眼滔滔云共雾	fhif
郭应祥	yypy
过犹不及	fqge
国有疑难可问谁	ldxy
过雨看松色	ffrq
郭圆	yblk
郭郧	ybkm
国运兴衰	lfiy
过则改之	fmnp
过则勿惮改	fmqn
郭章	ybuj
郭正一	yggg
国之本在家	lpsp
郭子正	ybgh
郭遵	ybus
还必相迎取	gnsb
还从物外起田园	gwtl
孩儿立志出乡关	bquu
海风吹不断	imko
海哥	itsk
还归长安去	gjtf
害浣害否	pipg
还将两行泪	gugi
还京乐	gyqi
还军霸上	gpfh
还看今朝	grwf
海客乘天风	iptm
海客谈瀛洲	ipyi
海录碎事	ivdg
海门深不见	iuim
海内风尘诸弟隔	immb
海鸥何事更相疑	iawx
海畔云山拥蓟城	ilff
海气湿蛰熏腥臊	irie
还寝梦佳期	gpsa
海色晴看雨	iqjf
海山仙子国	imwl
海上风雨至	ihmg
海上谣	ihye
海上有仙山	ihdm
海神来过恶风回	ipgl
还是读书	gjyn
还睡	giht
还似旧时游上苑	gwha
海棠不惜胭脂色	iigq
海棠春	iidw
海棠花	iiaw
海天愁思正茫茫	igta
海天阔处	igut
海外徒闻更九州	iqty
还相随	gsbd
还掩故园扉	grdy
海燕双栖玳瑁梁	iaci
还应酿老春	gysd
还有吃的	gdkr
还与星河次	ggju
还在人间否	gdwg
还作江南会	gwiw
韩碑	fjdr
汉兵奋迅如霹雳	irdf
汉兵屯在轮台北	irgu
寒波澹澹起	piif
韩察	fjpw
汉朝公卿忌贾生	ifwt
韩垂	fjtg
韩琮	fjgp
菡萏发荷花	aana
菡萏金芙蓉	aaqa
邯郸先震惊	autn
菡萏香销翠叶残	aatg
汉道昌	iujj
含德之厚	wtpd
寒灯独可亲	poqu
寒灯独夜人	poqw
寒灯思旧事	polg
汉帝金茎云外直	iuqf
汉帝重阿娇	iutv
寒冬十二月	ptfe
韩非囚秦	fdld
汉宫春慢	ipdn
汉宫词	ipyn
寒姑	pfvd
汉广	icyy
含光混世贵无名	wiiq
汗光珠点点	iigh
韩翃	fjdc
寒花葬志	paaf
韩璜	fjga
汉家秦地月	ipde
汉家青史上	ipgh
汉家山东二百州	ipmy
汉家烟尘在东北	ipou
汉奸何多	ivwq
韩绛	fjxt
汉将辞家破残贼	iutm
汉将归来虏塞空	iujp
汉江临眺	iijh
寒江雪柳日新晴	pifj
韩驹	fjcq
韩濬	fjih
寒林空见日斜时	pspj
寒柳	pfsq
寒梅最堪恨	psjn
汗牛充栋	irys
汉女输橦布	ivld
寒禽与衰草	pwga
寒磬满空林	pfis
含情欲说宫中事	wnwg
寒山	pfmm
寒山吹笛唤春归	pmkj
寒山转苍翠	pmln
韩生画马真是马	ftgc
寒声一夜传刁斗	pfgu
寒食词	pwyn
汉使断肠对归客	iwop
寒食寄京师诸弟	pwpu
寒树依微远天外	pswq
汉水接天回	iirl
汉水亦应西北流	iiyi
韩思复	fltj
寒随一夜去	pbgf
寒塘欲下迟	pfwn
撼庭秋	ryto
韩魏之经营	ftpa
汉文皇帝有高台	iyrc
汉文有道恩犹薄	iyda
含曦	wyju
韩熙载	fafa
汉下白登道	igru
韩仙姑	fwvd
含笑看吴钩	wtrq
含笑问檀郎	wtuy
寒心未肯随春态	pnfd
韩休	fjws
寒雪梅中尽	pfsn
寒鸦栖复惊	pasn
含烟惹雾每依依	woaw
寒夜天光白	pygr
韩仪	fjwy
寒衣处处催刀尺	pytn
汉有游女	idiv
韩屿	fjmg
寒月悲笳	pedt
寒云路几层	pfkn
韩昭	fjjv
汉之广矣	ipyc
韩准	fjuw
行当封侯归	tifj
行当浮桂棹	tiis
行名失己	tqrn
杭州等地	sytf
豪荡感激	yadi
浩荡及关愁	iaet
浩荡寄南征	iapt
号东坡居士	kaff
好鹅寻道士	vtvf
好风襟袖知	vmpt
好刚不好学	vmgi
浩歌待明月	iste
豪歌急鼓送寒来	ysqg
好观音	vcuj
浩浩风起波	iimi
浩浩观湖江	iici
好花时	vajf
好客见当时	vpmj
好乐何如	vqwv
好乐无荒	vqfa
好离乡	vyxt
毫毛不敢有所近	ytgr
好梦惊回	vsnl
好谋而成者也	vydb
好女儿	vvqt
浩然离故关	iqyu
浩然天地间	iqgu
好仁不好学	vwgi
豪圣凋枯	ycus
好是春风湖上亭	vjdy
好时光	vjiq
好是行春野望中	vjtk
好是正直	vjgf
昊天罔极	jgms
好为庐山谣	vyyy
号物之数谓之万	ktpd
好信不好学	vwgi
好行小慧	vtid
好勇不好学	vcgi
好勇疾贫	vcuw
好直不好学	vfgi
好知不好学	vtgi
好竹连山觉笋香	vtlt
好自相扶将	vtsu
郝子直	fbfh
何必待之子	wntb
何必读书	wnyn
何必改作	wnnw
何必高宗	wnyp
何必金与钱	wnqq
何必劳神苦思	wnal
何必龙山好	wndv
何彼襛矣	wtpc
何必求神仙	wnfw
何必求知音	wnfu
何必曰利	wnjt
何必珍珠慰寂寥	wngp
何不改乎此度	wgny
曷不肃雍	jgvy
和不欲出	tgwb
贺朝	lkfj
鹤巢松树遍	pvsy
何处哀筝随急管	wtyt
何处飞来双白鹭	wtnk
何处还相遇	wtgj
何处何服则安道	wtwu
何处浣纱人	wtiw
何处寄相思	wtpl
何处青山是越中	wtgk
何处闻灯不看来	wtug
何处无竹柏	wtfs
何处西南任好风	wtsm
何处寻行迹	wtvy
何从何道则得道	wwwu
何待来年	wtgr
何当重相见	witm
何当击凡鸟	wifq
何当施教化	wiyw
何当一来游	wigi
何当载酒来	wifg
何德之衰	wtpy
河东凶亦然	iaqq
荷动知鱼散	afta
河渎神	iipy
和而不唱	tdgk
何妨吮短毫	wvky
荷风送香气	amur
何敢助妇语	wney
盍各言尔志	ftyf
河广	isyy
何光远	wifq
和郭沫若同志	tyif
赫赫师尹	ffjv
赫赫始祖	ffvp
荷花娇欲语	aavy
荷花媚	aavn
荷花羞玉颜	aauu
荷花夜开风露香	aayt
合欢	wgcq
合昏尚知时	wqij
贺及	lkey
何敬	wsaq
何竟日默默在此	wujh
鹤胫虽长	pekt
何可废也	wsyb
何可胜道也哉	wsef
何可胜言	wsey
何可一日无此君	wsgv
贺兰进明	lufj
贺兰山下阵如云	lumf
何劳荆棘始堪伤	waaw
和乐且湛	tqei
和泪试严妆	tiyu
和泪折残红	tirx
何理不可得	wggt
荷笠带夕阳	atgb
河流入断山	iitm
和柳亚子先生	tsgt
何鸾	wsyo
河满子	iibb
鹤鸣于九皋	pkgr
何莫学夫诗	waiy
何莫由斯道也	wamb
何乃太区区	weda
河难凭	icwt
何年致此身	wrgt
和凝	tkux
何频瑜	whgw
何其多能也	waqb
何其久也	waqb
曷其有佸	jadw
曷其有极	jads
合气于漠	wrgi
何弃之有	wypd
河桥不相送	isgu
何情不诉	wngy
贺卿得高迁	lqtt
何求美人折	wfur
何人到白云	wwgf
何忍独为醒	wvqs
何人斯	wwad
何人倚剑白云天	wwwg
何日大刀头	wjdu
何日复归来	wjtg
何日平胡虏	wjgh
何日是归年	wjjr
何日是归期	wjja
何日忘之	wjyp
何如北地春	wvud
何如薄幸锦衣郎	wvay
何如德之衰也	wvtb
何如其知也	wvab
河润九里	iivj
河山北枕秦关险	imub
河上仙翁去不回	ihwl
贺圣朝	lcfj
禾生陇亩无东西	ttbs
河声入海遥	ifte
何事不可为	wggy
何事不语	wggy
何时旦	wjjg
何时返旆勒燕然	wjrq
何时缚住苍龙	wjxd
何时更杯酒	wjgi
何事偏向别时圆	wgwl
何事入罗帏	wgtm
何时石门路	wjdk
何时一杯酒	wjgi
何时倚虚幌	wjwm
何事于仁	wggw
何时照我还	wjjg
河水龙门	iidu
河水清且涟猗	iiiq
河水洋洋	iiii
何思何虑则知道	wlwu
何似人间	wwwu
何斯违斯	wafa
何所慰吾诚	wrny
何为不仁	wygw
何谓宠辱若惊	wypn
何谓贵大患若身	wykt
何为其然也	wyab
何谓仁义	wywy
何谓四恶	wylg
何谓五美	wygu
何为则民服	wyme
何谓真人	wyfw
何惜醉流霞	wnsf
和岘	tkmm
贺新凉	luuy
何须身后千载名	wetq
何须生入玉门关	wetu
何言复来还	wytg
河阳诗	ibyf
和杨元素	tsfg
荷叶枯时秋恨成	aksd
荷叶罗裙一色裁	aklf
荷叶生时春恨生	aktt
何夜无月	wyfe
何以拜姑嫜	wnrv
何以报仇	wnrw
何以报德	wnrt
何以别乎	wnkt
何意出此言	wuby
何以穿我屋	wnpn
何以穿我墉	wnpf
何以待之	wntp
何以伐为	wnwy
何以解忧思	wnql
何以利吾国	wntl
何以利吾家	wntp
何以利吾身	wntt
何异飘飘托此身	wnst
和以天倪	tngw
何以文为	wnyy
何以有羽翼	wndn
何以赠之	wnmp
何意致不厚	wugd
何因北归去	wluf
何用别寻方外去	wekf
何用不臧	wegd
何用草书夸神速	weag
何用浮名绊此身	weit
何用孤高比云月	webe
何由成名	wmdq
何有何亡	wdwy
何有于我哉	wdgf
何由知吾可也	wmtb
和雨和烟两不胜	tfte
合于桑林之舞	wgcr
和云翥	tfft
何赞	wstf
合葬华山傍	waww
合则成体	wmdw
和之以天倪	tpnw
曷至哉	jgfa
贺知章	ltuj
和之至也	tpgb
何仲举	wwiw
和周士钊同志	tmff
合从缔交	wwxu
何足怪乎	wknt
曷足贵乎	jkkt
何足算也	wktb
黑白太分明	lrdj
黑漆弩	livc
黑手高悬霸主鞭	lrya
恨不移封向酒泉	ngtr
恨春宵	ndpi
恨分明	nwje
恨赋	nvmg
恨恨那可论	nnvy
恨来迟	ngny
恨私心有所不尽	ntnn
恨无知音赏	nfti
横放杰出	sysb
横过幽林尚独游	sfxi
横空出世	spba
横空盘硬语	spty
衡门	tquy
衡门之下	tupg
横槊赋诗	sumy
横塘路	sfkh
衡阳归雁几封书	tbjn
横云	safc
红窗迥	xpmk
红窗听	xpkr
鸿飞冥冥日月白	inpr
鸿飞那复计东西	invs
红粉楼中应计日	xosj
洪皓	iart
薨薨兮	aawg
红荆	xaag
红军不怕远征难	xpgc
红蜡泪	xjih
红莲池里白莲开	xaig
红莲落故衣	xaay
红楼隔雨相望冷	xsbu
红楼引	xsxh
红罗复斗帐	xltm
红罗帐里不胜情	xlmn
红罗著压逐时新	xlau
红梅不屈服	xsge
红泥小火炉	xiio
红娘子	xvbb
红旗卷起农奴戟	xyuf
红旗漫卷西风	xyim
红旗跃过汀江	xyki
红情	xang
红情绿意	xnxu
红蕖何事亦离披	xawr
红裙妒杀石榴花	xpva
訇然中开	qqkg
红入桃花嫩	xtsv
红芍药	xaax
洪适	iatd
红树花迎晓露开	xsag
洪水横流	iisi
红桃绿柳垂檐向	xsxt
红霞万朵百重衣	xfdy
红星乱紫烟	xjto
红颜白发云泥改	xurn
鸿雁不堪愁里听	idgk
鸿雁几时到	idmg
鸿雁那从北地来	idvg
红颜弃轩冕	xuyj
红颜未相识	xufy
鸿雁于飞	idgn
鸿雁之什	idpw
红叶晚萧萧	xkja
红衣浅复深	xyii
红雨随心翻作浪	xfbi
红紫不以为亵服	xhge
宏兹九德	puvt
后悔遁而有他	rnrw
后来鞍马何逡巡	rgav
侯冽	wnug
侯蒙	wnap
后身缘	rtxx
后生可畏	rtsl
后生可畏吾衰矣	rtsc
后生可畏吾知子	rtsb
后世必为子孙忧	rann
后庭花	ryaw
后庭花破子	ryab
后庭宴	rypj
侯王将相望久绝	wgux
侯王若能守之	wgap
侯置	wnlf
后重前轻	rtul
忽报人间曾伏虎	qrwh
忽奔走以先后兮	qdfw
胡不遄死	dgmg
胡曾	deul
胡传美	dwug
忽到窗前疑是君	qgpv
忽到庞公栖隐处	qgyt
胡德芳	dtay
胡得焉	dtgh
蝴蝶儿	jjqt
蝴蝶梦中飞	jjsn
呼儿将出换美酒	kqui
胡儿能唱琵琶篇	dqct
胡儿十岁能骑马	dqfc
胡儿眼泪双双落	dqha
胡玢	degw
忽逢青鸟使	qtgw
忽复隔淮海	qtbi
胡杲	dejs
虎鼓瑟兮鸾回车	hfgl
胡浩然	diqd
忽魂悸以魄动	qfnf
胡笳一声愁绝	dtgx
忽见寒梅树	qmps
忽见陌头杨柳色	qmbq
忽见千帆隐映来	qmtg
壶浆半成土	fuuf
扈江离与辟芷兮	yiyw
虎距龙盘今胜昔	hkda
虎踞龙盘今胜昔	hkda
虎可搏	hsrg
胡窥青海湾	dpgi
胡令能	dwce
胡马大宛名	dcdq
胡能有定	dcdp
忽念山中客	qwmp
胡骑长驱五六年	dctr
胡骑凭陵杂风雨	dcwf
狐裘以朝	qfnf
胡取禾三百廛兮	dbtw
忽然而已	qqdn
忽然更作渔阳掺	qqgr
忽然浪起	qqif
忽然一夜春风来	qqgg
忽然遭时变	qqgy
胡人落泪沾边草	dwaa
湖山信是东南美	imwu
湖上一回首	ihgu
虎视何雄哉	hpwf
胡世将	dauq
虎兕出于柙	hmbs
胡松年	dsrh
胡宿	depw
壶天晓	fgja
户庭无尘杂	yyfv
户外一峰秀	yqgt
胡为乎来哉	dytf
胡为乎泥中	dytk
胡为乎中露	dytf
胡为劳其生	dyat
忽闻歌古调	qusy
忽闻河东狮子吼	quik
忽闻江上弄哀筝	quit
胡文卿	dyqt
胡无人	dfww
惚兮恍兮	nwnw
胡雄	dedc
胡旋女	dyvv
胡雁哀鸣夜夜飞	ddyn
胡雁鸣	ddkq
忽焉在后	qgdr
胡翼龙	dndx
胡于	degf
湖月照我影	iejj
扈载	ynfa
胡仔	dewb
胡证	deyg
壶中天	fkgd
胡州	deyt
画地而趋	gfdf
画栋朝飞南浦云	gsff
画娥眉	gvnh
化而为鸟	wdyq
化而欲作	wdww
花犯念奴	aqwv
画阁朱楼尽相望	gury
画工如山貌不同	gavm
花红柳绿宴浮桥	axss
花间意	auuj
画角声中	gqfk
画锦堂	gqip
花开花落几春风	agam
花开花落人如旧	agah
花开堪折直须折	agfr
画梁斜	giwt
画楼初满月	gspe
花路入溪口	aktk
花落家童未扫	aapr
花满洛阳城	aiif
花蔓宜阳春	aapd
花满自然秋	aitt
画眉深浅入时无	gnif
花明柳暗绕天愁	ajst
花明月暗笼轻雾	ajef
花飘万家雪	asdf
花气薰人欲破禅	arap
花前失却游春侣	aurw
花前饮	auqn
花强妾貌强	axux
华清宫	wipk
华清引	wixh
划然变轩昂	aqyj
花上月令	ahew
花深深	aiip
画松	glsw
华亭鹤唳讵可闻	wypu
画图麒麟阁	glyu
画图省识春风面	glid
花褪残红青杏小	apgi
华佗无奈小虫何	wwfw
化为狼与豺	wyqe
化为绕指柔	wyxc
花无百日开	afdg
花舞大唐春	ardd
花溪碧	aigr
华夏文明	wdyj
花下醉	agsg
花相容	aspw
花心愁欲断	anto
花心动	anfc
花须连夜发	aeln
华胥引	wnxh
花隐掖垣暮	abra
花迎剑佩星初落	aqwa
化育万物	wydt
花月正春风	aegm
花枝欲动春风寒	aswp
花自落	atai
化作啼鹃带血归	wwkj
坏壁无由见旧题	fnfj
怀楚	ngss
怀古钦英风	ndqm
怀归人自急	njwq
怀归伤暮秋	njwt
怀旧游	nhiy
怀君属秋夜	nvny
怀民亦未寝	nnyp
淮南木落楚山多	ifsq
淮南一叶下	ifgg
淮上对秋山	ihcm
淮上女	ihvv
淮阴市井笑韩信	ibyw
患不知人也	kgtb
换巢鸾凤	rvym
环而攻之而不胜	gdae
桓公方读书	swyn
桓公杀公子纠	swqx
还家草露晞	gpaj
还家少欢趣	gpif
换了人间	rbwu
环佩空归月下魂	gwpf
环佩空归月夜魂	gwpf
患其不能也	kagb
唤起工农千百万	kfad
患其无用	kafe
环球同此凉热	ggmr
浣纱明月下	ixjg
浣沙溪	iiie
患所以立	krnu
还我河山	gtim
幻想和现实	xstp
欢笑情如旧	ctnh
欢言得所憩	cytt
幻者衫来作主人	xfpw
欢醉中	cskh
黄尘足今古	aikd
荒城古道	afdu
荒城临古渡	afji
黄诚之	aypp
黄崇嘏	amdn
黄帝得之	autp
黄幡绰	amxh
皇甫曾	rgul
皇甫冉	rgmf
黄夫人	afww
皇甫松	rgsw
黄格	amst
黄革	amaf
黄公度	awya
黄鹤高楼已捶碎	apyd
黄鹤楼前春水阔	apsu
黄鹤楼中吹玉笛	apst
黄河落天走东海	aiai
黄河如丝天际来	aivg
黄河西来决昆仑	aisw
黄鹤之飞尚不得	appt
黄鹤知何去	aptf
黄河之水天上来	aipg
黄花寒后难逢蝶	aapj
皇皇三十载	rrdf
煌煌太宗业	oodo
皇皇者华	rrfw
黄昏到寺蝙蝠飞	aqgn
黄昏独上海风秋	aqqt
黄昏独倚阑	aqqu
黄昏胡骑尘满城	aqdf
黄昏饮马傍交河	aqqi
黄机	amsm
黄金白璧买歌笑	aqrt
黄金缕	aqxo
黄金燃桂尽	aqon
黄金锁子甲	aqql
恍惊起而长嗟	nnfk
黄静淑	agih
荒居旧业贫	anhw
黄麟	amyn
黄鸟黄鸟	aqaq
黄鸟鸣园柳	aqks
黄鸟时兼白鸟飞	aqjn
黄鸟于飞	aqgn
黄颇	amhc
黄泉共为友	arad
黄泉下相见	argm
黄人杰	awso
黄仁荣	awap
黄山旧绕汉宫斜	amhw
黄裳元吉	aiff
黄时龙	ajdx
黄师塔前江水东	ajfa
荒戍落黄叶	adak
黄水村	aisf
黄舜英	aeam
黄损	amrk
黄谈	amyo
黄滔	amie
皇天后土	rgrf
皇天无老眼	rgfh
黄庭坚	ayjc
黄童	amuj
黄童白叟	aurv
黄洋界上	ailh
黄洋界上炮声隆	ailb
黄叶仍风雨	akwf
黄衣狐裘	ayqf
黄莺久住浑相识	aaqy
黄应武	ayga
黄云陇底白雪飞	afbn
黄云万里动风色	afdq
黄云萧条白日暗	afaj
黄宰	ampu
黄载	amfa
黄钟乐	aqqi
黄州寒食诗帖	aypm
黄州快哉亭记	ayny
黄铢	amqr
黄铸	amqd
黄竹歌声动地哀	atsy
黄子行	abtf
晦庵	jtyd
嘒彼小星	ktij
挥鞭且就胡姬饮	raeq
回飙经画壁	ldxn
回波词	liyn
回波乐	liqi
会昌城外高峰	wjfm
挥斥八极	rrws
惠崇烟雨归雁	gmod
回到天上去	lggf
惠而好我	gdvt
蟪蛄不知春秋	jjgt
挥毫落纸如云烟	ryao
惠洪	gjia
虺虺其雷	ggaf
慧寂	dhph
悔教夫婿觅封侯	nffw
回看天际下中流	lrgi
会哭皆豪杰	wkxs
回廊四合掩寂寞	lylp
回乐峰前沙似雪	lqmf
会盟而谋弱秦	wjdd
回梦旧鸳机	lshs
卉木萋萋	fsaa
惠然肯来	gqhg
回日楼台非甲帐	ljsm
诲汝知之乎	yitt
挥手从兹去	rrwf
回首恨依依	lunw
挥手泪沾巾	rrim
回首乱山横	luts
回首彭城	luff
回首自纤纤	lutx
回虽不敏	lkgt
回头语小姑	luyv
回望高城落晓河	lyyi
会向瑶台月下逢	wtgt
回心院	lnbp
会须一饮三百杯	wegs
慧宣	dhpg
回崖沓障凌苍苍	lmia
回也不改其乐	lbgq
回也不愚	lbgj
回也其庶乎	lbat
会遭此祸	wghp
惠则足以使人	gmkw
晦之	jtpp
讳之	yfpp
回舟不待月	ltge
惠子吊之	gbkp
惠子相梁	gbsi
悔作商人妇	nwuv
魂返关塞黑	frul
昏昏灯火话平生	qqot
浑浑沌沌	iiii
混江龙	iidx
魂来枫林青	fgsg
魂梦任悠扬	fswr
魂去尸长留	ffnq
魂随南翥鸟	fbfq
浑脱	ipeu
昏以为期	qnya
或百步而后止	adhh
或承之羞	abpu
或从十五北防河	awfi
惑而不从师	adgj
祸福相生	ppst
或告之曰	atpj
火聚开莲花	obga
或恐是同乡	aajx
或凭几学书	awmn
或强或羸	axay
或去或不去	afaf
霍如羿射九日落	fvna
火山五月行人少	omgi
火尚足以明也	oikb
火树银花合	osqw
火维地荒足妖怪	oxfn
或谓惠子曰	aygj
或谓孔子曰	aybj
或问之曰	aupj
或问子产	aubu
或五十步而后止	agfh
或笑邓艾吃	atck
或益之而损	aupr
或在于渚	adgi
惑之不解	apgq
霍总	fwuk
获罪于天	algg
激昂丹墀下	ijmg
基本传统	aswx
既辨	vcuy
羁泊欲穷年	liwr
骥不称其力	cgtl
既不能令	vgcw
季布无二诺	tdfy
记承天寺夜游	ybgi
几处吹笳明月夜	mtky
鸡初鸣	cpkq
即此羡闲逸	vhuq
记得当年草上飞	ytin
既得其母	vtax
积德为厚地	ttyf
既雕既琢	vmvg
季冬除夜接新年	ttbr
鸡斗始开笼	cuvt
几度隔山川	mybk
几度木兰舟上望	mysy
几度斜晖	mywj
及尔颠覆	eqfs
及尔同死	eqmg
及尔偕老	eqwf
肌肤若冰雪	eeaf
寄蜉蝣于天地	pjjf
技盖至此乎	rugt
击鼓吹箫	ffkt
机关用尽不如君	suev
殛鲧於羽山	gqym
寄韩谏议	pfyy
既寒亦既清	vpyi
几行陈迹	mtby
几行归塞尽	mtjn
寄贺方回	plyl
芰荷香	aatj
籍何以至此	twnh
季桓子受之	tsbp
寄黄几复	pamt
几回梦里忆红颜	mlsu
积毁销金	tvqq
寂寂花时闭院门	ppau
饥籍家家米	qtpo
寂寂江山摇落处	ppit
寂寂竟何待	pput
寂寂寥寥扬子居	pppn
鸡既鸣矣	cvkc
寂寂人定初	ppwp
寂寂闻猿愁	pput
急击勿失	qfqr
几家能彀	mpcf
既见复关	vmtu
既见君子	vmvb
技兼于事	rugg
鸡叫子	ckbb
既竭吾才	vugf
几尽而去	mndf
即今河畔冰开日	vwij
技经肯綮之未尝	rxhi
汲井漱寒齿	ifih
鸡聚族以争食	cbyw
季康子问	tybu
饥渴寒暑	qipj
击空明兮泝流光	fpji
疾雷破山	ufdm
寄李儋元锡	pswq
肌理细腻骨肉匀	egxq
寄令狐郎中	pwqk
迹留伤堕屦	yqwn
季路问事鬼神	tkup
羁旅长堪醉	lyts
吉梦维何	fsxw
鸡鸣不已	ckgn
鸡鸣胶胶	ckee
鸡鸣喈喈	ckkk
鸡鸣入机织	cktx
鸡鸣桑树颠	ckcf
鸡鸣外欲曙	ckqj
鸡鸣紫陌曙光寒	ckhp
寂寞嫦娥舒广袖	ppvp
寂寞开最晚	ppgj
寂寞空庭春欲晚	pppj
寂寞山城人老也	ppmb
寂寞身后事	pptg
寂寞使人愁	ppwt
寂寞天宝后	ppgr
寂寞心自知	ppnt
寂寞掩柴扉	ppry
寂寞养残生	pput
极目楚天舒	shsw
极目萧条三两家	shap
济南名士多	ifqq
及其更也	eagb
及其老也	eafb
及其使人也	eawb
及其有事	eadg
鸡栖于桀	csgq
鸡栖于埘	csgf
鸡栖于厅	csgd
及其壮也	eaub
即遣花开深造次	vkau
几千里	mtjf
及前王之踵武	eugg
寄全椒山中道士	pwsf
鸡犬声相闻	cdfu
几日到临洮	mjgi
积善成德	tudt
寄上浮梁大兄	phik
寄身且喜沧洲近	pter
极深研几	sidm
几声抽泣	mfri
既生既育	vtvy
几声凄厉	mfud
几时杯重把	mjsr
季氏第十六	tqtu
季氏富于周公	tqpw
几时回	mjlk
几世几年	mamr
季氏将伐颛臾	tquv
季氏旅于泰山	tqym
祭石曼卿文	wdjy
济世岂邀名	iamq
吉事尚左	fgid
及时相遣归	ejsj
嵇氏幼男犹可悯	tqxn
吉士诱之	ffyp
寄书长不达	pntd
几树惊秋	msnt
积水成渊	tidi
积水得反壑	tith
饥思河鲤与河鲂	qliq
纪叟黄泉里	xvaj
极天关塞云中	sguk
祭天神	wgpy
积土成山	tfdm
洎外供奉	iqwd
既往不咎	vtgt
既往不可追	vtgw
积威约之渐也	tdxb
寄卧郊扉久	pauq
既无叔伯	vfhw
寂兮寥兮	pwpw
集贤宾	wjpr
既相逢	vstd
极相思	ssln
吉祥止止	fphh
棘心夭夭	gntt
寄兄弟	pkux
积雪浮云端	tfiu
急雪舞回风	qfrm
寄雁传书谢不能	pdwc
寄言全盛红颜子	pywb
激扬文字	iryp
寄扬州韩绰判官	pryp
际夜转西壑	bylh
既已为一矣	vnyc
既诒我肄	vytx
及以至是	engj
寄友人	pdww
己欲达而达人	nwdw
迹与孤云远	ygbf
集于灌木	wgis
系于教育	tgfy
积雨空林烟火迟	tfpn
寄与陇头人	pgbw
寄语洛城风日道	pyiu
既欲其生	vwat
积雨辋川庄作	tflw
急于星火	qgjo
寄远人	pfww
期月而已可也	aedb
霁月光风	feim
饥者易为食	qfjw
既至金门远	vgqf
及至始皇	egvr
即之也温	vpbi
祭之以礼	wpnp
吉中孚	fkeb
机中锦字论长恨	skqn
机中织锦秦川女	skxv
寄诸弟	pyux
击筑饮美酒	ftqi
计拙是和亲	yrju
棘子成曰	gbdj
及兹契幽绝	eudx
既阻我德	vbtt
及罪至罔加	elgl
既遵道而得路	vuuk
寄左省杜拾遗	pdik
驾彼四牡	ltlt
家必自毁	pntv
嘉宾复满堂	fpti
贾曾	smul
贾昌朝	sjfj
贾驰	smcb
贾岛	smqy
嫁得瞿塘贾	vths
甲第连青山	ltlm
驾鸿凌紫冥	liup
家家春鸟鸣	ppdk
嘉节迫吹帽	farm
佳节清明桃李笑	wait
佳境千万曲	wftm
贾棱	smsf
架梁之椽	lips
家临九江水	pjvi
假令风歇时下来	wwmg
嘉陵水	fbii
佳气满山川	wrik
佳人彩云里	wwej
佳人一壶酒	wwgi
佳人醉	wwsg
佳色	wfqc
嘉善而矜不能	fudc
家山好	pmvb
贾少卿	siqt
贾生才调更无伦	stfw
贾生年少虚垂泪	stri
佳时倍惜风光别	wjwk
贾氏窥帘韩掾少	sqpi
家书到隔年	pngr
家童鼻息已雷鸣	putk
家徒四壁书侵坐	ptlw
加我林壑清	ltsi
加我数年	ltor
驾言出游	lybi
贾奕	smyo
加以订正	lnyg
贾谊上书忧汉室	syhp
驾一叶之扁舟	lgkt
贾应	smyi
嘉佑进士	fwff
家有老妪	pdfv
假舆马者	wwcf
嫁与弄潮儿	vggq
家在梦中何日到	pdsg
家在西南	pdsf
贾至	smgc
家之本在身	ppst
加彘肩上	lxyh
加之以师旅	lpny
假舟楫者	wtsf
家住层城邻汉苑	pwna
家住水东西	pwis
贾宗	smpf
兼爱无私	ueft
坚闭门而不出	juub
饯别王十一南游	qkgi
坚冰一时合	jugw
见不善如探汤	mgui
渐车帷裳	ilmi
坚持原则	jrdm
见此良人	mhyw
建此伟业	vhwo
见此邂逅	mhqr
剪刀声	uvfn
建德非吾土	vtdf
建德若偷	vtaw
涧底束荆薪	iyga
涧底松	iysw
见尔当何秋	mqit
剑非万人敌	wddt
剑歌易水湄	wsji
剑阁峥嵘而崔嵬	wumm
剑河风急雪片阔	wimu
涧户寂无人	iypw
见几而作	mmdw
简洁优美	tiwu
坚决抵抗	jurr
渐觉伤春暮	iiwa
见君绸缪思	mvxl
见君难	mvcw
见君前日书	mvun
见客棹歌回	mpsl
见空髑髅	mpmm
艰苦斗争	cauq
减兰	uduf
渐老逢春能几回	iftl
煎泪几千行	uimt
见利思义	mtly
见龙门	mduy
减米散同舟	uoat
见冕者与瞽者	mjff
剪牡丹	utmy
简能而任之	tcdp
见牛未见羊也	mrfb
见其二子焉	mafg
剑气近	wrrp
剑气射云天	wrtg
见齐衰者	myyf
贱日岂殊众	mjmw
健如黄犊走复来	wvag
见身外身	mtqt
见时少	mjit
检书烧烛短	snot
涧水东流复向西	iias
见说蚕丛路	mygk
见说风流极	myms
谏太宗十思疏	ydpn
鉴堂	jtip
剑外从军远	wqwf
见危授命	mqrw
歼我良人	gtyw
简兮	tuwg
简兮简兮	twtw
见小曰明	mijj
拣选撰刻留山阿	rtrb
建业暮钟时	voaj
见已读书	mnyn
鉴亦有光	jydi
见与儿童邻	mgqw
渐与骨肉远	igmf
剪朝霞	uffn
见志不从	mfgw
间至军中	ugpk
肩之所倚	yprw
剪纸招我魂	uxrf
见竹不见人	mtgw
减字浣溪沙	upii
见子夏曰	mbdj
将安将乐	upuq
将翱将翔	uruu
江北江南水拍天	iuig
江北秋阴一半开	iutg
江碧鸟逾白	igqr
江边柳	ilsq
江边一树垂垂发	ilgn
江表传	igwf
匠伯不顾	awgd
江采萍	ieai
蒋璨	augh
江草江花处处鲜	iaiq
江城白酒三杯酽	ifrs
江城梅花引	ifsx
江城如画里	ifvj
江城五月落梅花	ifga
将船买酒白云边	utnl
绛唇珠袖两寂寞	xdgp
江村八九家	iswp
将村独归处	usqt
江村月落正堪眠	iseh
江东日暮云	iajf
江东子弟今虽在	iabd
绛都春	xfdw
江儿水	iqii
江妃	iavn
江风引雨入舟凉	imxu
蒋桂战争	ashq
江国逾千里	ilwj
江海翻波浪	iiti
江汉曾为客	iiup
江汉春风起	iidf
江汉江汉思归客	iiip
江涵秋影雁初飞	iitn
江汉西来	iisg
江河横溢	iisi
江湖多风波	iiqi
江湖秋水多	iitq
江湖夜雨十年灯	iiyo
江淮度寒食	iiyw
蒋涣	auiq
江火似流萤	iowa
蒋吉	aufk
将家就鱼麦	upyg
姜皎	ugru
江静潮初落	igia
将军得名三十载	uptf
将军画善盖有神	upgp
将军兼领霍嫖姚	upuv
将军猎渭城	upqf
将军楼阁画神仙	upsw
将军魏武之子孙	uptb
将军下笔开生面	upgd
将军欲以巧伏人	upww
将军战河北	uphu
江开	iaga
将老身反累	uftl
蒋冽	auug
江岭作流人	imww
江柳共风烟	isao
江流曲似九回肠	iime
江流石不转	iidl
江路野梅香	ikjt
江袤	iayc
江梅引	isxh
将命者出户	uwfy
将奈之何	udpw
江南春绝句	ifdq
江南怀古	ifnd
江南佳丽地	ifwf
江南江北旧家乡	ifix
江南江北青山多	ifiq
江南江北送君归	ifij
江南柳	ifsq
江南渌水多	ifiq
江南孟夏天	ifbg
江南弄	ifga
江南有丹橘	ifds
江南瘴疠地	ifuf
姜女庙	uvym
江畔洲如月	ilie
江如练	ivxa
江山此夜寒	imhp
江山故宅空文藻	imda
江山留胜迹	imqy
江山如此多娇	imvv
江山如有待	imvt
江山犹是昔人非	imqd
江上几人在	ihmd
江上流莺独坐听	ihik
江上小堂巢翡翠	ihin
江上行	ihtf
江上雪	ihfv
江上吟	ihkw
江上月明胡雁过	ihef
江上值水如海势	ihwr
江神子	ipbb
江声夜听潮	ifyi
匠石之齐	adpy
将数百之众	uodw
江树远含情	isfn
江水江花岂终极	iiis
江水绿如蓝	iixa
江水三峡	iidm
江水为竭	iiyu
姜特立	utuu
江天水一泓	igii
蒋挺	aurt
江头宫殿锁千门	iupu
江万里	idjf
将往复旋如有情	uttn
江为	iayl
江纬	iaxf
江无	iafq
姜晞	ugjq
江夏行	idtf
将心托明月	unre
蒋兴祖女	aipv
江衍	iati
将以反说约也	unrb
将以愚之	unjp
将因卧病解朝衣	ulay
江有汜	idin
将欲辞君挂帆去	uwtf
将欲废之	uwyp
将欲歙之	uwwp
江月令	iewy
江月去人只数尺	iefn
江云欲变霞	ifwf
将炙啖朱亥	uqky
降志辱身矣	bfdc
江之永矣	ipyc
将仲子兮	uwbw
将子无怒	ubfv
蒋子云	abfc
教吹箫	fktv
搅得周天寒彻	rtmt
教儿且覆掌中杯	fqes
骄儿诗	cqyf
教诲之人	fypw
皎皎白驹	rrrc
皎皎河汉女	rriv
交交黄鸟	uuaq
胶胶角角鸡初鸣	eeqk
矫矫珍木巅	ttgm
椒聊	shbq
鹪鹩巢于深林	wdvs
蛟龙出没猩鼯号	jdbk
蛟龙得云雨	jdtf
蛟龙生焉	jdtg
骄其妻妾	cagu
教妾若为容	fuap
骄人好好	cwvv
佼人僚兮	wwww
教人以善	fwnu
皎如飞镜临丹阙	rvnu
矫如群帝骖龙翔	tvvu
皎如玉树临风前	rvgu
娇软不胜垂	vlgt
教使之然也	fwpb
教授所著	frra
狡童	qtuj
教以人伦	fnww
教以慎于接物	fnnt
焦郁	wyde
交语速装束	uygg
教育振兴	fyri
郊原血	udtl
教者必以正	ffng
脚著谢公屐	eayn
解鞍欹枕绿杨桥	qads
节彼南山	atfm
街垂千步柳	ttts
解春风	qdmq
解道醒来无味	qusk
截断巫山云雨	foaf
戒多言	aqyy
介尔景福	wqjp
嗟尔君子	kqvb
嗟尔远道之人	kqfw
结发受长生	xnet
结发授长生	xnrt
结发同枕席	xnmy
结发未识事	xnfg
皆反求诸己	xrfn
皆共尘沙老	xaif
接汉疑星落	rixa
解红	qexa
节候看应晚	awrj
戒厚味	adkf
嗟乎	kutu
羯胡事主终无赖	udgg
嗟君此别意何如	kvhv
嗟君万里行	kvdt
解缆君已遥	qxve
解落三秋叶	qadk
节南山	afmm
皆能有养	xcdu
洁念乐空寂	iwqp
解佩令	qwwy
皆入于机	xtgs
戒奢以俭	adnw
解绅宜就水	qxpi
解释春风无限恨	qtdn
节使三河募年少	awdi
结束多红粉	xgqo
借书满架	wnil
借水开花自一奇	wigd
结袜子	xpbb
解琬	qegp
皆为龙虎	xydh
借问吹箫向紫烟	wuko
借问此何时	wuhj
借问汉宫谁得似	wuiw
借问君去何方	wuvy
借问苦心爱者谁	wuay
借问路傍名利客	wukp
借问瘟君欲何往	wuut
借问新安吏	wuug
嗟我怀人	ktnw
节物风光不相待	atmt
皆物之情也	xtpb
揭傒斯	rwad
阶下青苔与红树	bggs
皆向沙场老	xtif
解心释神	qntp
皆兄弟也	xkub
皆雅言也	xayb
皆言夫婿殊	xyfg
皆言四海同	xylm
解衣欲睡	qywh
节用而爱人	aedw
解冤结	qpxf
嗟哉吾党二三子	kfgb
睫在眼前长不见	hdhm
戒之戒之	apap
皆知善之为善	xtuu
戒之慎勿忘	apny
竭忠尽孝	uknf
谨拜表以闻	yrgu
今拜乎上	wrth
金鞭断折九马死	qaog
金鞭络绎向侯家	qaxp
锦缠道	qxut
金蟾啮锁烧香入	qjkt
金昌绪	qjxf
今朝拜首临欲别	wfrk
今臣亡国贱俘	wayw
今成断根草	wdoa
今成流泪泉	wdir
锦城虽云乐	qfkq
今春花鸟作边愁	wdat
今春看又过	wdrf
晋祠流水如碧玉	gpig
金错刀	qqvn
金带连环束战袍	qglp
晋代衣冠成古丘	gwyr
近得归京邑	rtjk
金灯花	qoaw
金地藏	qfad
巾短情长	mtnt
金多众中为上客	qqwp
锦帆应是到天涯	qmyi
金凤钩	qmqq
今夫天下之人牧	wfgt
金浮图	qilt
今夫颛臾	wfmv
金谷怀古	qwnd
今古空名	wdpq
筋骨之强	tmpx
金棺葬寒灰	qsad
金河秋半虏弦开	qitg
金猴奋起千钧棒	qqds
今花几开落	wama
今见功名胜古人	wmaw
金蕉叶	qakf
矜矜兢兢	ccdd
金井梧桐秋叶黄	qfsa
金菊对芙蓉	qaca
金菊香	qatj
今看两楹奠	wrgu
矜夸紫骝好	cdhv
今来典斯郡	wgmv
近来攀折苦	rgsa
近泪无干土	riff
筋力交凋丧	tluf
锦里开芳宴	qjgp
禁里疏钟官舍晚	sjnj
锦里烟尘外	qjoq
金陵凤凰台	qbmc
金陵凤凰台置酒	qbmi
金陵津渡小山楼	qbis
金陵酒肆留别	qbik
金陵望汉江	qbyi
金陵子弟来相送	qbbu
金炉香尽漏声残	qotg
金缕词	qxyn
金缕歌	qxsk
禁门宫树月痕过	supf
仅免刑焉	wqgg
金明春	qjdw
今年春尽	wrdn
今年花落颜色改	wran
今年花似去年好	wrav
尽年年	nrrh
今漂沦憔悴	wiin
金叵罗	qalq
金阙前开二峰长	quut
金阙晓钟开万户	qujy
今人不见古时月	wwge
今人多不弹	wwqx
今人还对落花风	wwgm
金人秋泪	qwti
今人未可非商鞅	wwfa
今日被驱遣	wjpk
今日病矣	wjuc
今日长缨在手	wjtr
今日垂杨生左肘	wjte
今日大风寒	wjdp
今日得宽余	wjtw
今日得宽馀	wjtq
今日非昨日	wjdj
今日逢君君不识	wjty
今日俸钱过十万	wjwd
今日还家去	wjgf
今日花开又一年	wjar
今日欢呼孙大圣	wjcc
今日江头两三树	wjis
今日龙钟人共老	wjdf
今日凄凉南浦	wjui
今日水犹寒	wjip
今日武将军	wjgp
今日向何方	wjty
今日之事	wjpg
今日之事何如	wjpv
近入千家散花竹	rttt
浸润之谮	iipy
今若遣此妇	wakv
锦瑟无端五十弦	qgfx
金沙水拍云崖暖	qiij
尽善尽美	nunu
锦上花	qhaw
今上岳阳楼	whrs
金声而玉振	qfdr
近时郭家狮子花	rjya
近试上张水部	ryhu
今事有急	wgdq
谨守而勿失	ypdr
津树多枫橘	isqs
锦水东北流	qiai
今四十年	wlfr
近死之心	rgpn
金粟堆前松柏里	qsfj
今岁今宵尽	wmwn
尽态极妍	ndsv
锦堂春	qidw
锦堂春慢	qidn
今天之旋	wgpy
进退无颜仪	fvfw
今亡矣夫	wycf
今为羌笛出塞声	wyuf
今我不乐	wtgq
今我不乐思岳阳	wtgb
今我游冥冥	wtip
金吾不禁夜	qggy
金屋无人见泪痕	qnfu
今吾于人也	wggb
尽吾志也	ngfb
今夕复何夕	wqtq
今夕亦何夕	wqyq
谨庠序之教	yyyf
今宵好向郎边去	wpvf
今宵月	wpee
尽心力而为之	nnlp
尽心焉耳矣	nngc
金星妆成娇侍夜	qjuy
进学解	fiqe
禁烟	ssol
晋阳已陷休回顾	gbnd
今夜不知何处宿	wygp
今夜残灯斜照处	wygt
今夜鄜州月	wyye
今也则亡	wbmy
今也制民之产	wbru
尽意凄凉	nuuu
今已亭亭如盖矣	wnyc
今又重阳	wctb
今由与求也	wmgb
金舆不返倾城色	qwgq
金玉满堂	qgii
锦园春	qldw
今月曾经照古人	weuw
今则不然	wmgq
金盏子	qgbb
锦帐春	qmdw
今朝此为别	wfhk
今朝都到眼前来	wffg
今朝风日好	wfmv
今朝歌管属檀郎	wfsy
今朝更好看	wfgr
今朝郡斋冷	wfvu
今朝腊月春意动	wfef
今朝霜重东门路	wffk
今朝蟢子飞	wfjn
今朝杨柳半垂堤	wfsf
今者项庄拔剑舞	wfar
今者有小人之言	wfdy
今之从政者殆而	wpwd
今之君子	wpvb
今之狂也荡	wpqa
今之人也	wpwb
今之孝者	wpff
今之新图有二马	wpuc
今之学者为人	wpiw
近之则不孙	rpmb
今之众人	wpww
近种篱边菊	rtta
金字经	qpxc
金樽对绮筵	qsct
径草踏还生	takt
景池	jyib
惊定还拭泪	npgi
经冬复立春	xttd
经冬犹绿林	xtqs
精而又精	odco
惊飞远映碧山去	nnff
惊风乱飐芙蓉水	nmti
荆歌艳楚腰	asde
靖共尔位	uaqw
静故了群动	gdbf
惊呼热中肠	nkre
镜湖三百里	qidj
镜湖水如月	qiie
惊回首	nlut
荆棘生焉	agtg
净境重阳节	ufta
菁菁者莪	aafa
井九百亩	fvdy
京口流江航	ykit
净理了可悟	ugbn
泾流之大	iipd
京洛多风尘	yiqi
京洛缝春衣	yixy
荆门九派通	auvc
荆门送别	auuk
精妙世无双	ovac
静女其娈	gvay
静女其姝	gvav
旌旆逶迤碣石间	yytu
惊破绿窗幽梦	ndxs
旌旗初下玉关东	yypa
旌旗奋	yydl
敬其事而后其食	aagw
荆人	agww
井上有李	fhds
井深冻不成	fiud
敬事而信	agdw
经始灵台	xvvc
荆叔	aghi
井水为君盟	fiyj
井税有常期	ftda
京镗	yiqi
经天纬地	xgxf
镜天无一毫	qgfy
静听松风寒	gksp
静为躁君	gykv
惊闻俗客争来集	nuww
荆吴相接水为乡	aksx
竟夕起相思	uqfl
竟夕自悲秋	uqtt
净显	uqjo
径须沽取对君酌	teis
静言思之	gylp
静夜四无邻	gylw
井有仁焉	fdwg
净圆	uqlk
静曰复命	gjtw
静者心多妙	gfnv
经之营之	xpap
精之至也	opgb
镜中人	qkww
竞舟	ukte
荆州歌	aysk
荆州亭	ayyp
迥立阊阖生长风	muum
迥临村路傍溪桥	mjss
迥临飞鸟上	mjnh
久别离	qkyb
久不见若影	qgmj
就不欲入	ygwt
九重春色	vtdq
九重谁省谏书函	vtyb
九雏鸣凤乱啾啾	vqkk
久读枯神	qysp
舅夺母志	vdxf
久而敬之	qdap
久而弥笃	qdxt
酒舫泛泛然	itiq
旧风流	hmiy
旧谷既没	hwvi
旧国见青山	hlmm
救国良方	flyy
九国之师	vlpj
旧好隔良缘	hvbx
九华山人	vwmw
九回肠	vlen
九佳	vtwf
旧家燕子傍谁飞	hpan
旧将军	hupl
究竟人高品雅	puwa
久久莫相忘	qqay
赳赳武夫	ffgf
酒阑不必看茱萸	iuga
鹫翎金仆姑	ywqv
旧令尹之政	hwvg
九龙呵护玉莲房	vdky
咎莫大于欲得	tadt
九陌祥烟合	vbpw
樛木	snss
旧南阁子也	hfub
九年面壁	vrdn
就其浅矣	yaic
就其深矣	yaic
九青	vtge
酒倾愁不来	iwtg
酒泉子	irbb
九人而已	vwdn
九日登高望	vjwy
九日黄花酒	vjai
九日齐山登高	vjyy
九山郁峥嵘	vmdm
旧时栏楯	hjss
九十五字	vfgp
九死南荒吾不恨	vgfn
九岁不行	vmgt
九泰	vtdw
九天阊阖开宫殿	vgun
九天开出一成都	vggf
酒徒历历坐洲岛	itdq
九万八千	vdwt
九万里	vdjf
九微片片飞花琐	vttg
久为簪组累	qytl
久相待	qstf
九屑	vtni
九蟹	vtqe
酒星不在天	ijgg
酒醒南望隔天涯	isfi
旧业已随征战尽	honn
九嶷山上白云飞	vmmn
就有道而正焉	ydug
厩有肥马	ddec
久有凌云志	qduf
旧友悉零落	hdta
九罭	vtla
九渊	vtit
旧苑荒台杨柳新	haau
九月初二日	vepj
九月初九日	vepj
九月寒砧催木叶	vepk
九月九日	vevj
九月九日望乡台	vevc
九月九日望遥空	vevp
九月三十日	vedj
九月在户	vedy
救赵挥金槌	ffrs
酒中堪累月	ikfe
居必迁坐	nntw
俱不得其死然	wgtq
举臣秀才	iatf
居处不安	ntgp
举动自专由	iftm
句读之不知	qypt
举尔所知	iqrt
具告沛公	htiw
具告以事	htng
鞠歌行	astf
鞠躬如也	atvb
据湖岸	rimd
菊花何太苦	aawa
菊花开菊花残	aagg
菊花天	aagd
菊花新	aaus
俱怀鸿鹄志	wnif
俱会大道口	wwdk
居简而行简	ntdt
居敬而行简	nadt
举酒属客	iinp
句句皆绝伦	qqxw
讵肯感激徒媕婀	yhdv
举匏樽以相属	idsn
距其院东五里	kabj
居人共住武陵源	nwai
居人未改秦衣服	nwfe
举觞白眼望青天	iqrg
居上不宽	nhgp
举身赴清池	itfi
居是邦也	njdb
俱是梦中人	wjsw
举手可近月	irse
举手来相招	irgr
掬水月在手	rier
居天下之广居	nggn
举头望山月	iuye
举枉错诸直	isqf
俱往矣	wtct
菊翁	aqwc
居闲始自遣	nuvk
剧辛乐毅感恩分	nuqw
居延城外猎天骄	ntfc
举言谓新妇	iyyv
俱邀侠客芙蓉剑	wrww
据亿丈之城	rwdf
拘于虚也	rghb
居域中之大	nfkd
聚则为生	bmyt
居之不疑	npgx
举直错诸枉	ifqs
居之无倦	npfw
聚之咸阳	bpdb
橘子洲头	sbiu
卷春空	udpw
娟娟戏蝶过闲幔	vvcm
卷三九	udvt
卷上珠帘总不如	uhgv
卷舒自如	uwtv
卷帷望月空长叹	umyk
倦寻芳	wvay
卷一百八十	ugdf
卷一百八十二	ugdf
卷一百八十三	ugdd
卷一百八十一	ugdg
卷一百六十八	ugdw
卷一百六十五	ugdg
卷一百七十九	ugdv
卷一百七十六	ugdu
卷一百七十五	ugdg
卷一百七十一	ugdg
卷云山	ufmm
狷者有所不为也	qfdb
卷珠帘	ugpw
绝壁临巨川	xnjk
绝壁耸万仞	xnww
绝代有佳人	xwdw
觉道资无穷	iuup
绝顶一茅茨	xsga
绝壑开花界	xhgl
攫鸟不搏	rqgr
绝巧弃利	xayt
绝仁弃义	xwyy
绝圣弃智	xcyt
爵位自高言尽废	ewty
厥有国语	ddly
绝域苍茫更何有	xfad
君爱身后名	vetq
君安与项伯有故	vpgd
君不见青海头	vgmu
君不闻	vgub
君不悟	vgng
君臣一梦	vags
君臣已与时际会	vanw
君臣之义	vapy
君宠益娇态	vpud
君当作磐石	viwd
君尔妾亦然	vquq
军阀重开战	puth
君歌且休听我歌	vses
君歌声酸辞且苦	vsfa
君还何所望	vgwy
君既若见录	vvav
君既为府吏	vvyg
君家白碗胜霜雪	vprf
君家妇难为	vpvy
君家何处住	vpww
军叫工农革命	pkaw
俊杰在位	wsdw
君今不幸离人世	vwga
君今在罗网	vwdm
君看似花处	vrwt
君来路	vgkh
君怜无是非	vnfd
军旅之事	pypg
君马黄	vcam
君门客如水	vupi
君门深九重	vuit
君莫停	vawy
君起舞	vfrl
君情与妾意	vngu
君去试看汾水上	vfyh
君仁莫不仁	vwaw
军声动至今	pffw
君使臣以礼	vwap
君孰与不足	vygk
君孰与足	vygk
君王赐颜色	vgmq
君为东道主	vyay
君为女萝草	vyva
君为我呼入	vytt
君问穷通理	vupg
郡县逼迫	vegr
君行仁政	vtwg
君须记	veyn
君言不得意	vygu
俊逸鲍参军	wqqp
郡邑浮前浦	vkii
君义莫不义	vyay
君曰	vtjh
君之视臣如犬马	vppc
君之视臣如手足	vppk
君之视臣如土芥	vppa
军中无以为乐	pkfq
君子病无能焉	vbug
君子不齿	vbgh
君子不可小知	vbgt
君子不以言举人	vbgw
君子不忧不惧	vbgn
君子不怨天	vbgg
君子不重则不威	vbgd
君子耻之	vbbp
君自此远矣	vthc
君子淡以亲	vbiu
君子道者三	vbud
君子笃于亲	vbtu
君子多乎哉	vbqf
君子固穷	vblp
君子和而不同	vbtm
君子怀德	vbnt
君子惠而不费	vbgx
君子疾夫舍曰	vbuj
君子矜而不争	vbcq
君子敬而无失	vbar
君子居之	vbnp
君子可逝也	vbsb
君子乐胥	vbqn
君子谋道不谋食	vbyw
君子求诸己	vbfn
君子去仁	vbfw
君子人也	vbwb
君子人与	vbwg
君子上达	vbhd
君子尚勇乎	vbit
君子生非异也	vbtb
君子食无求饱	vbwq
君子思不出其位	vblw
君子所依	vbrw
君子泰而不骄	vbdc
君子陶陶	vbbb
君子无所争	vbfq
君子无众寡	vbfp
君子偕老	vbwf
君子学道则爱人	vbiw
君子学以致其道	vbiu
君子阳阳	vbbb
君子以仁存心	vbnn
君子意如何	vbuw
君子以文会友	vbnd
君子一言以为知	vbgt
君子义以为上	vbyh
君子义以为质	vbyr
君子亦有穷乎	vbyt
君子有酒	vbdi
君子有九思	vbdl
君子有三变	vbdy
君子有三戒	vbda
君子有三畏	vbdl
君子有终身之忧	vbdn
君子于其所不知	vbgt
君子于其言	vbgy
君子哉若人	vbfw
君子者乎	vbft
君子贞而不谅	vbhy
君子正其衣冠	vbgp
君子之车	vbpl
君子之道	vbpu
君子之德风	vbpm
君子质而已矣	vbrc
君子之过也	vbpb
君子之人	vbpw
君子之仕也	vbpb
君子之守	vbpp
君子之于天下也	vbpb
君子之泽	vbpi
君子之至于斯也	vbpb
君子周而不比	vbmx
君子周急不继富	vbmp
君子作之	vbwp
君醉留妾家	vsqp
开成三年	gddr
岂弟君子	muvb
凯风自南	mmtf
凯歌	mnsk
开国何茫然	glwq
开过尚盈盈	gfie
开荒南野际	gafb
开揭磊砢	grdd
开帘见新月	gpme
开门复动竹	gutt
开门无犬吠	gufk
开门雪满山	gufm
开箧泪沾臆	gtie
慨然抚长剑	nqrw
开塞随行变	gpby
开天辟地君真健	ggnw
开拓词境	gryf
开帷月初吐	gmek
开箱验取石榴裙	gtcp
开轩纳微凉	glxu
开轩卧闲敞	glai
开元二十六年	gffr
开元乐	gfqi
开元之中常引见	gfpm
开妆镜也	guqb
看红妆素裹	rxuy
看花回	ralk
看花满眼泪	raii
看剑引杯长	rwxt
看君击狂节	rvfa
看君马去疾如鸟	rvcq
坎坎伐辐兮	ffww
坎坎伐檀兮	ffww
坎坎鼓我	ffft
侃侃如也	wwvb
坎轲只得移荆蛮	flky
看来平常	rggi
看取汉家何事业	rbio
看取莲花净	rbau
看松露滴身	rsft
槛外长江空自流	sqti
看万山红遍	rdmy
堪笑兰台公子	ftub
看余度石桥	rwys
看朱成碧思纷纷	rrdx
看竹何须问主人	rtww
慷慨动颜魄	nnfr
康骈	yvcu
康与之	ygpp
康子馈药	ybqa
考槃	ftte
考槃在涧	ftdi
可爱深红爱浅红	seix
柯崇	ssmp
可传而不可受	swde
客从东方来	pwag
客从何处来	pwwg
可得而不可见	stdm
可得而闻也	stdb
可得见	stmq
可得闻乎	stut
可得闻与	stug
客何为者	pwyf
可恨年年赠离别	snrk
克己复礼为仁	dntw
可怜春半不还家	sndp
可怜邓道士	sncf
可怜飞燕倚新妆	snnu
可怜闺里月	snue
可怜焦土	snwf
可怜九马争神骏	snvc
可怜缭乱点	snxh
可怜体无比	snwx
可隆	skbt
可名为大	sqyd
可名于小	sqgi
可奈情怀	sdnn
可朋	skee
客去波平槛	pfis
可容一人居	spgn
柯如青铜根如石	svgd
客散酒醒深夜后	pair
可上九天揽月	shve
可使食无肉	swwm
可使有勇	swdc
可使足民	swkn
客思倍从来	plwg
客思似杨柳	plws
咳唾落九天	kkag
可望不可即	sygv
可望不可攀	sygs
可谓好学也已	syvn
可谓好学也已矣	syvc
可谓明矣	syjc
可谓仁乎	sywt
可谓仁矣	sywc
可谓仁之方也已	sywn
可谓士矣	syfc
可为识者规	syyf
可畏惟人	slnw
可谓孝矣	syfc
可谓知乎	sytt
可谓知矣	sytc
客喜而笑	pfdt
可惜一溪风月	snge
可下五洋捉鳖	sggu
客心何事转凄然	pnwq
客心洗流水	pnii
客心争日月	pnqe
可言可意	sysu
可以保身	snwt
可以长久	sntq
可以横绝峨眉巅	snsm
可以寄百里之命	snpw
可以荐嘉客	snap
可以解忧	snqn
可以尽年	snnr
可以全生	snwt
刻意伤春复伤别	yuwk
可以使能	snwc
可以仕则仕	snww
可以托六尺之孤	snrb
可以为错	snyq
可以为难矣	snyc
可以无大过矣	snfc
可以无悔矣	snfc
可以休兮	snww
可以养亲	snuu
可以有国	sndl
可以语上也	snyb
可以止则止	snhh
可以濯我缨	snix
可以濯我足	snik
可以卒千年	snyr
客有吹洞箫者	pdkf
可与共学	sgai
可与适道	sgtu
柯原	ssdr
可者与之	sfgp
客至	ptgc
客中行	pktf
克终者盖寡	dxfp
肯数邺下黄须儿	hooq
肯与邻翁相对饮	hgwq
空悲昔人有	pdad
空悲远游子	pdfb
恐不任我意	agwu
空城澹月华	pfiw
空城雀	pfiw
空持罗带	prlg
空床难独守	pycp
恐此事非奇	ahgd
空翠落庭阴	pnab
空翠烟霏	pnof
孔德绍	btxv
孔德之容	btpp
空洞无一物	pift
恐非平生魂	adgf
空歌易水寒	psjp
空故纳万境	pdxf
箜篌曲	ttma
箜篌谣	ttye
恐皇舆之败绩	arwx
空见葡萄入汉家	pmap
恐结他生里	axwj
孔矩	bntd
空觉极圆	pisl
空空如也	ppvb
空劳流水声	paif
空令岁月易蹉跎	pwmk
恐美人之迟暮	auwa
孔明庙前有老柏	bjys
恐年岁之不吾与	armg
孔平仲	bgwk
孔雀东飞何处栖	bias
空山百鸟散还合	pmdw
空山秋气清	pmti
空山松子落	pmsa
空山啼夜猿	pmkq
孔绍安	bxpv
恐是汉代韩张良	ajiy
空水共氤氲	piar
空王应念我	pgyt
空闻虎旅传宵柝	puhs
空闻子夜鬼悲歌	pubs
孔武有力	bgdl
空向秋波哭逝川	pttk
空烟迷雨色	pooq
孔夷	bngx
空忆谢将军	pnyp
空有当年旧烟月	pdie
空有羡鱼情	pdun
空余泪痕	pwiu
空园白露滴	plri
空知返旧林	ptrs
孔稚圭	btff
空中闻天鸡	pkuc
孔子不见	bbgm
孔子辞以疾	bbtu
孔子对曰	bbcj
孔子观于吕梁	bbci
孔子过之	bbfp
孔子沐浴而朝	bbif
孔子师郯子	bbjb
孔子谓季氏	bbyq
孔子闻之	bbup
孔子西行不到秦	bbsd
孔子于乡党	bbgi
寇泚	pfih
口道恒河沙复沙	kuni
叩关而攻秦	kudd
扣关无僮仆	rufw
口角流沫右手胝	kqie
扣门无犬吠	rufk
口如含朱丹	kvwm
扣舷而歌之	rtdp
寇埴	pfff
寇准	pfuw
哭晁卿衡	kjqt
苦道来不易	augj
苦含情	awng
枯木怪石图	ssnl
枯木朽株齐努力	sssl
苦情重诉	anty
枯桑老柏寒飕飗	scfm
哭声直上干云霄	kfff
枯松倒挂倚绝壁	sswn
枯松倒涧壑	sswh
酷相思	ssln
苦心岂免容蝼蚁	anmj
哭宣城善酿纪叟	kpfv
枯鱼过河泣	sqfi
苦雨终风也解晴	afxj
跨海斩长鲸	kilq
跨马出郊时极目	kcbh
脍不厌细	egdx
快活年	nirh
快活三	nidg
会稽愚妇轻买臣	wtja
快剑砍断生蛟鼍	nwdk
快马加鞭未下鞍	ncla
块石枕头	fdsu
快哉亭作	nfyw
宽厚而爱人	pddw
宽心应是酒	pnyi
旷安宅而弗居	jppn
狂飙为我从天落	qdya
况臣孤苦	uaba
狂而不直	qdgf
狂风暴雨终摧折	qmjr
狂风吹我心	qmkn
狂风挽断最长条	qmrt
狂夫富贵在青春	qfpd
况复秦兵耐苦战	utdh
狂歌五柳前	qsgu
匡衡抗疏功名薄	atra
况爵禄乎	uept
狂客归舟逸兴多	qpjq
狂来轻世界	qgll
匡庐一带不停留	aygq
况乃未休兵	uefr
匡山读书处	amyt
况是蔡家亲	ujau
况是青春日将暮	ujga
况属高风晚	unyj
狂童之狂也且	qupe
旷兮其若谷	jwaw
况余白首	uwru
旷哉至人心	jfgn
狂者进取	qffb
匡之直之	apfp
狂醉	qtsg
夔府孤城落日斜	uybw
窥见室家之好	pmpv
傀儡吟	wwkw
窥室惟案几	ppnm
困而不学	ldgi
困而学之	ldip
昆鸡长笑老鹰非	jctd
昆明池	jjib
鲲鹏水击三千里	qeij
鲲鹏展翅	qenf
喇叭声咽	kkfk
腊梅花	esaw
腊梅香	estj
蜡照半笼金翡翠	jjun
来当婀娜时	givj
来对白头吟	gcrk
来而记之者已少	gdyi
来鹄	gotf
来即我谋	gvty
来来去去如风卷	ggfu
来去九江侧	gfvw
来日大难	gjdc
来日犹可追	gjqw
来如雷霆收震怒	gvfv
来世不可待	gagt
来是空言去绝踪	gjpk
来试人间第二泉	gywr
来时万里同为客	gjdp
来途若梦行	gwat
来往不逢人	gtgw
来往预期程	gtct
赖问空门知气味	gupk
来吾导夫先路	ggnk
赖以拄其间	gnru
来者复为谁	gfty
赖兹托令门	guru
兰桂芳	usay
懒画眉	ngnh
烂嚼红茸	okxa
兰陵美酒郁金香	ubut
揽裙脱丝履	rpen
兰若生春夏	uatd
蓝水远从千涧落	aifa
懒堂女子	nivb
蓝田日暖玉生烟	aljo
兰叶春葳蕤	ukda
揽衣推枕起徘徊	ryrt
兰之猗猗	upqq
狼跋	qtkh
狼跋其胡	qkad
浪打天门石壁开	irgg
浪花有意千里雪	iadf
浪里来煞	ijgq
廊深阁迥此徘徊	yiut
郎士元	yffq
浪淘沙北戴河	iiii
浪淘沙令	iiiw
浪下三吴起白烟	igdo
浪笑榴花不及春	itsd
郎亦坏人心	yyfn
浪自生百忧	ittn
老病有孤舟	fudt
老大意转拙	fdur
老而不死	fdgg
老而无夫曰寡	fdfp
劳而无功	adfa
劳光彩	aies
劳苦而功高如此	aadh
劳劳送客亭	aauy
劳劳亭	aayp
劳力者治於人	alfw
老年花似雾中看	frar
老妻画纸为棋局	fggn
老去悲秋强自宽	ffdp
老去恋明时	ffyj
老人七十仍沽酒	fwai
老僧已死成新塔	fwnf
劳生有限	atdb
老使我怨	fwtq
劳心悄兮	annw
老忧王室泣铜驼	fngc
老者安之	ffpp
老者衣帛食肉	ffym
老至居人下	fgng
劳之来之	apgp
乐彼之园	qtpl
乐道人之善	quwu
乐多贤友	qqjd
乐而不淫	qdgi
乐观态度	qcdy
乐国乐国	qlql
乐极哀来月东出	qsyb
乐郊乐郊	ququ
乐令	qiwy
乐民之乐者	qnpf
乐其可知也	qasb
乐且有仪	qedw
乐然后笑	qqrt
乐世	qian
乐岁终身饱	qmxq
乐岁终身苦	qmxa
乐土乐土	qfqf
乐婉	qivp
乐以忘忧	qnyn
乐亦在其中	qydk
乐亦在其中矣	qydc
乐游春苑断肠天	qidg
乐幽心屡止	qxnh
乐游原上清秋节	qida
乐游原上望昭陵	qidb
乐云乐云	qfqf
乐只君子	qkvb
泪飞顿作倾盆雨	ingf
雷鼓动山川	fffk
泪痕消夜烛	iuio
泪红云	ixfc
磊磊落落桃花结	ddax
泪落连珠子	ialb
雷霆走精锐	fffq
泪向客中多	itpq
泪亦不能为之堕	iygb
类与不类	oggo
酹月	sgee
泪珠和笔墨齐下	igtg
冷处偏佳	utww
冷翠烛	unoj
冷灰残烛动离情	udgn
冷冥冥	uppj
冷溶溶	uiip
冷笑置之而已	utln
冷烟和月	uote
冷眼向洋看世界	uhtl
冷朝阳	ufbj
李百药	sdax
李白一斗诗百篇	srgt
离杯惜共传	ysnw
李壁	sbnk
离别何足叹	ykwk
离别正堪悲	ykgd
李搏	sbrg
李播	sbrt
李渤	sbif
李伯虎	swha
立不中门	ugku
力不足也	lgkb
力不足者	lgkf
李岑	sbmw
李曾伯	suwr
李昌符	sjtw
李昌邺	sjog
李朝卿	sfqt
李澄之	sipp
李赤	sbfo
李持正	srgh
李处全	stwg
李从善	swud
李从远	swfq
李从周	swmf
李得	sbtj
立德明道	utju
李德润	stiu
李憕	sbnw
立登要路津	uwsi
李洞	sbim
李端	sbum
立而饮之	udqp
黎逢	tqtd
李逢吉	stfk
李福业	spog
李甘	sbaf
骊歌一叠	csgc
李肱	sbed
李广无功缘数奇	syfd
李瀚	sbif
李行言	styy
李好古	svdg
李好义	svyq
李何	sbws
李和风	stmq
离恨空随江水长	ynpt
李侯有佳句	swdq
梨花白雪香	tart
梨花淡白柳深青	taig
李花开	saga
梨花满地不开门	taiu
梨花千树雪	tatf
李怀远	snfq
李回	sblk
理会是非遣	gwjk
李姬传	svwf
李季萼	stak
李季华	stwx
李季兰	stuf
李家明	spje
李嘉佑	sfwd
李嘉祐	sfpy
李建枢	svsa
李建勋	svkm
李绛	sbxt
李结	sbxf
李节	sbab
力尽关山未解围	lnul
历尽天华成此景	dngj
李谨言	syyy
李景伯	sjwr
李敬方	sayy
李景俭	sjww
李景良	sjyv
李景让	sjyh
李敬玄	sayx
李敬则	samj
李迥秀	smte
李玖	sbgq
李九龄	svhw
李居仁	snwf
李君行	svtf
李伉	sbwy
李康成	sydn
李克恭	sdaw
吏课升斗积	gytt
离苦海	yait
李夔	sbuh
力困衰怠竭	llyu
李廓	sbyy
历览前贤国与家	djup
历历开元事	ddgg
历历历历开元事	dddg
李谅	sbyy
李令	sbwy
李隆基	sbad
离鸾	ybyo
离鸾别凤烟梧中	yykk
李吕	sbkk
李昴英	sjam
李梦符	sstw
李秘	sbtn
黎民不饥不寒	tngp
李溟	sbip
李明远	sjfq
李鼐	sbeh
李南金	sfqq
力排南山三壮士	lrff
李彭	sbfk
李频	sbhi
李朴	sbsh
李颀	sbrd
李栖筠	sstf
李潜	sbif
李峤	sbmt
李清臣	siah
离情终日思风波	ynxi
李璆	sbgn
李衢	sbth
鲤趋而过庭	qfdy
李群玉	svgy
里仁第四	jwtl
丽人行	gwtf
李日新	sjus
李如璧	svnk
骊山北构而西折	cmur
李山甫	smge
李商英	suam
李韶	sbuj
利涉	tjih
吏舍局终年	gwnr
李深	sbip
李绅	sbxj
栗深林兮惊层巅	sism
李石才	sdft
李世民	sana
李士元	sffq
李适之	stpp
李氏子蟠	sqbj
李收	sbnh
李纾	sbxc
李叔霁	shfy
李斯税驾苦不早	satj
李竦	sbug
李太玄	sdyx
李坦然	sfqd
离堂思琴瑟	yilg
李体仁	swwf
李天骥	sgcu
离天三尺三	ygdd
立天下之正位	uggw
历天又入海	dgci
黎廷瑞	ttgm
离亭宴	yypj
离亭燕	yyau
鲤退而学礼	qvdp
鲤退而学诗	qvdy
李汶儒	siwf
李渥	sbin
李习	sbnu
李希仲	sqwk
李暇	sbjn
李咸	sbdg
李岘	sbmm
李咸用	sdet
离形去知	ygft
李序	sbyc
李续	sbxf
李宣古	spdg
李宣远	spfq
李旬	sbqj
李询	sbyq
李延陵	stbf
溧阳公主年十四	ibwl
李曜	sbjn
李冶	sbuc
李邺	sbog
李乂	sb
李亿	sbwn
李嶷	sbmx
李益	sbuw
李义府	syyw
礼以行之	pntp
李婴	sbmm
李郢	sbkg
理莹	gjap
李幼卿	sxqt
李屿	sbmg
李羽	sbnn
李虞	sbha
厉与西施	dgsy
李玉箫	sgtv
李愿	sbdr
李元纮	sfxd
李元嘉	sffk
李元卓	sfhj
梨园子弟白发新	tlbu
梨园子弟散如烟	tlbo
礼云礼云	pfpf
李赞华	stwx
李漳	sbiu
李章武	suga
李拯	sbrb
李正封	sgff
李骘	sbbh
礼之端也	ppub
历职郎署	dbyl
李之问	spuk
荔枝香近	astr
李仲光	swiq
李昼	sbny
李胄	sbme
利洲南渡	tifi
李子卿	sbqt
李子申	sbjh
李子酉	sbsg
李子正	sbgh
李宗闵	spuy
怜薄命	nawg
联步趋丹陛	bhfb
连昌宫词	ljpy
炼丹砂	omdi
怜蛾不点灯	njgo
廉而不刿	ydgm
连峰去天不盈尺	lmfn
敛尽春山羞不语	wndy
帘旌不动夕阳迟	pygn
怜君何事到天涯	nvwi
帘幕重重	patt
脸腻香薰似有情	eetn
恋情深	ynip
连山接海隅	lmrb
连山起烟雾	lmff
连山若波涛	lmai
连山晚照红	lmjx
莲生淤泥中	atik
廉氏	yuqa
帘外春寒赐锦袍	pqdp
恋香衾	ytwy
连云开甲宅	lfgp
连枝理	lsgj
连诸侯者次之	lywp
两岸桃花夹古津	gmsi
两岸猿声啼不尽	gmqn
良宝终见弃	ypxy
两别泣不休	gkiw
两不见	ggmq
两草犹一心	gaqn
良辰未必有佳期	ydfa
两处滴池水	gtii
梁大年	idrh
梁德裕	itpu
凉簟碧纱厨	utgd
凉风吹夜雨	umkf
凉风起天末	umfg
凉风日潇洒	umji
凉风只在殿西头	umku
梁父吟	iwkw
梁甫吟	igkw
梁父吟成恨有馀	iwkq
两汉乐府	giqy
梁惠王曰	iggj
梁惠王章句上	iggh
梁惠王章句下	iggg
两家求合葬	gpfa
良家子	ypbb
梁间燕子闻长叹	iuak
两口不团圆	gkgl
梁令	ivwy
良庖岁更刀	yymv
梁洽	iviw
良人罢远征	ywlt
两人对酌山花开	gwcg
良人玉勒乘骢马	ywgc
良人昨夜情	ywjn
两三星火是瓜州	gdjy
两水夹明镜	gigq
凉思	uyln
两同心	gmny
梁献	ivfm
良相头上进贤冠	ysup
良宵盛会喜空前	ypdu
两小无嫌猜	gifq
两心相照	gnsj
梁铉	ivqy
梁园日暮乱飞鸦	ilja
梁园吟	ilkw
两月共半边	geal
凉月如眉挂柳湾	uevi
梁震	ivfd
凉州胡人为我吹	uydk
梁州令	iywy
梁州梦	iyss
聊持宝剑动星文	brpy
料得年年断肠处	otrt
辽东小妇年十五	baig
蓼莪	anat
聊厚不为薄	bdga
聊可与娱	bsgv
寥廓江天万里霜	pyif
聊乐我员	bqtk
寥落悲前事	padg
寥落古行宫	padp
寥落寒山对虚牖	papt
廖凝	ynux
聊书所怀	bnrn
蓼萧	anav
廖行之	ytpp
廖有方	ydyy
烈风无时休	gmfw
列国自有疆	gltx
列郡讴歌惜	gvyn
烈女操	gvrk
列缺霹雳	grff
裂缺霹雳	grff
列传七十	gwaf
林表民	sgna
林表明霁色	sgjq
林楚翘	ssat
林淳	ssiy
临春风	jdmq
临洞庭	jiyt
林断山明竹隐墙	somf
林璠	ssgt
林放问礼之本	syus
临风怀谢公	jmnw
临风听暮蝉	jmkj
临感忽难收	jdqn
临高台	jyck
林革	ssaf
邻国相望	wlsy
邻国之民不加少	wlpi
林花发岸口	sank
林花扫更落	sara
林回弃千金之璧	slyn
林昏瘴不开	squg
临江王节士歌	jigs
林宽	sspa
林琨	ssgj
临流驻归驾	jicl
临路歌	jksk
临洛水	jiii
林茂鸟知归	saqj
林栖见羽毛	ssmt
临其穴	japw
邻人满墙头	wwiu
临人以德	jwnt
临丧不哀	jfgy
林深无人鸟相呼	sifk
林嵩	ssmy
林外	ssqh
林卧愁春尽	satn
林下何须远借问	sgwu
临行一杯酒	jtgi
林珝	ss
林仰	sswq
临颍美人在白帝	jxuu
林月低向后	sewr
林藻	ssai
麟之角	ypqe
临之以庄则敬	jpna
麟之趾	ypkh
林滋	ssiu
林自然	stqd
凌波曲	uima
凌波微步有人愁	uitt
凌波仙子生尘袜	uiwp
零丁孤苦	fsba
菱歌清唱不胜春	asid
令狐楚	wqss
令狐德棻	wqta
令狐峘	wqmg
令狐绹	wqxq
令将军与臣有郤	wupw
零泪缘缨流	fixi
泠泠彻夜	iity
泠泠七弦遍	iiay
泠泠七弦上	iiah
玲珑四犯	gglq
玲珑王	gggg
玲珑望秋月	ggye
零露瀼瀼	ffii
零露漙兮	ffiw
伶伦吹裂孤生竹	wwkt
零落成泥辗作尘	fadi
零落依草木	faws
伶俜萦苦辛	wwau
泠青沼	igiv
泠然善也	iqub
令人长号不自禁	wwts
令人发深省	wwni
令人行妨	wwtv
领如蝤蛴	wvjj
岭色千重万重雨	mqtf
灵山多秀色	vmqq
岭上晴云披絮帽	mhjm
岭树重遮千里目	msth
菱透浮萍绿锦池	atii
岭外音书绝	mqux
凌万顷之茫然	udxq
令行天下	wtgg
凌烟功臣少颜色	uoaq
零雨其濛	ffai
岭猿同旦暮	mqma
凌云健笔意纵横	ufws
灵准	vouw
刘褒	yjyw
柳边人歇待船归	slwj
留别王侍御维	qkgx
刘采春	yedw
柳曾	squl
刘叉	yjcy
刘敞	yjim
刘长川	ytkt
柳长春	stdw
刘常卿	yiqt
六朝文物草连空	ufyp
刘崇龟	ymqj
柳初新	spus
流传汉地曲转奇	iwid
刘大辨	yduy
刘道昌	yujj
刘得仁	ytwf
刘洞	yjim
刘蕃	yjat
柳逢	sqtd
刘复	yjtj
刘阜	yjwn
柳富	sqpg
柳拂旌旗露未干	sryf
刘皋	yjrd
刘耕	yjdi
刘珙	yjga
柳公绰	swxh
刘公兴	ywiw
刘谷	yjww
柳挂九衢丝	srvx
柳含烟	swol
刘沆	yjiy
榴花开欲然	sagq
刘晃	yjji
柳浑	sqip
刘几	yjmt
刘洎	yjit
刘济	yjiy
刘季孙	ytbi
刘脊虚	yiha
刘驾	yjlk
留家	qype
刘兼	yjuv
刘戬	yjgo
刘鉴	yjjt
刘将孙	yubi
刘泾	yjic
刘景翔	yjud
刘迥	yjmk
刘浚	yjic
刘均国	yflg
柳堪结	sfxf
刘轲	yjls
刘克逊	ydbi
留客住	qpwy
刘暌	yjjw
刘廓	yjyy
刘郎已恨蓬山远	yynf
浏漓顿挫	iigr
琉璃砚水长枯槁	ggds
流离之子	iypb
留连光景惜朱颜	qliu
流落征南将	iatu
柳绿更带朝烟	sxgo
柳绿更带春烟	sxgo
六麻	uyys
骝马新跨白玉鞍	ccua
刘袤	yjyc
六么序	utyc
柳泌	sqin
流年一掷梭	irgs
六盘山上高峰	utmm
刘錡	yjqd
刘潜	yjif
六曲屏山和梦遥	umne
流入宫墙	itpf
柳如丝	svxx
刘三复	ydtj
柳色黄	sqam
柳色黄金嫩	sqav
柳色新	squs
刘商	yjum
柳梢春	ssdw
刘慎虚	ynha
刘氏妇	yqvv
刘使君	ywvt
刘氏云	yqfc
六十字	ufpb
刘述	yjsy
流水如有意	iivu
流水十年间	iifu
流水通波接武冈	iicm
流水无情草自春	iifd
流水无心西复东	iifa
流俗之所轻也	iwpb
刘损	yjrk
刘太冲	yduk
刘太真	ydfh
刘坦	yjfj
柳棠	sqip
刘焘	yjdt
刘畋	yjlt
刘天迪	ygmp
柳条藤蔓系离情	stan
刘望	yjyn
刘望之	yypp
刘细君	yxvt
刘希夷	yqgx
刘宪	yjpt
刘仙伦	ywww
刘象	yjqj
流响出疏桐	ikbs
刘向传经心事违	ytwf
刘孝孙	yfbi
流星白羽腰间插	ijrr
刘性初	ynpu
刘行敏	yttx
柳絮飞时别洛阳	svnb
柳絮飞时花满城	svnf
刘学箕	yita
流血涂野草	itia
刘学颜	yiut
柳亚子先生	sgbt
刘炎	yjoo
刘言史	yykq
柳腰轻	selc
刘邺	yjog
柳叶儿	skqt
柳叶开时任好风	skgm
刘乙	yjnn
刘夷道	ygut
六亿神州尽舜尧	uwpa
刘一止	yghh
刘祎之	yppp
六英	uyam
流莺漂荡复参差	iaiu
刘应雄	yydc
流影照明妃	ijjv
刘幽求	yxfi
刘友贤	ydjc
六语	uyyg
六鱼	uyqg
刘元淑	yfih
六月	uyee
六月徂暑	uetj
六月时	uejf
六月天兵征腐恶	uegg
柳恽	sqnp
刘云甫	yfge
刘允济	yciy
刘赞	yjtf
刘皂	yjra
流照伏波营	ijwa
刘昭禹	yjtk
刘之才	ypft
柳枝秋	ssto
柳枝五首	ssgu
柳中庸	skyv
刘舟	yjte
留著舞衣中	qark
刘子实	ybpu
刘子玄	ybyx
柳宗元	spfq
留醉与山翁	qsgw
龙池柳色雨中深	disi
隆冬到来时	btgj
泷冈阡表	imbg
龙虎相啖食	dhsw
龙媒去尽鸟呼风	dvfm
龙丘居士亦可怜	drnn
龙山会	dmwf
陇上羊归塞草烟	bhuo
龙腾凤集	demw
陇头泉	buri
陇头水	buii
陇头月	buee
陇头云	bufc
龙衔宝盖承朝日	dtpj
龙吟虎啸一时发	dkhn
龙吟曲	dkma
陇云愁	bfto
龙种自与常人殊	dttg
露白宵钟彻	frpt
楼采	soes
楼观沧海日	scij
楼观岳阳尽	scrn
楼寒院冷接平明	spbj
楼兰斩未还	sulg
楼前宫畔暮江流	supi
楼上花枝笑独眠	shah
楼上黄昏欲望休	shaw
楼上曲	shma
楼台成海气	scdr
楼台深翠微	scit
楼台与天通	scgc
楼头张丽华	suxw
楼倚霜树外	swfq
楼颖	soxt
路隘林深苔滑	kbsi
陆翱	bfrd
卢藏用	haet
露草覆寒虫	fasj
陆长源	btid
卢储	hnwy
路出寒云外	kbpq
鹭点烟汀	khoi
路逢斗鸡者	ktuf
路贯	khxf
六合正相应	uwgy
卢鸿一	higg
露华	fkwx
露华春慢	fwdn
芦花深处泊孤舟	aait
炉火照天地	oojf
路极河流远	ksif
卢家少妇郁金堂	hpii
卢家少妇郁金香	hpit
陆坚	bfjc
虏箭如沙射金甲	htvl
陆敬	bfaq
卢景亮	hjyp
鲁酒薄而邯郸围	qial
鲁酒不可醉	qigs
虏酒千钟不醉人	hitw
卢橘杨梅次第新	hssu
卢钧	hnqq
陆凯	bfmn
鲁连特高妙	qltv
卢令	hnwy
辘轳金井	llqf
辘轳金井梧桐晚	llqj
卢纶	hnxw
鹿门月照开烟树	yues
鹿鸣之什	ykpw
路难思共济	kcli
路旁时卖故侯瓜	kujr
卢骈	hncu
卢频	hnhi
陆凭	bfwt
虏骑崩腾畏蒺藜	hcma
露气寒光集	frpw
虏骑千重只似无	hctf
鹿虔扆	yhyn
卢群	hnvt
卢汝弼	hixd
陆叡	bfhp
虏塞兵气连云屯	hprg
庐山东南五老峰	ymam
庐山秀出南斗傍	ymtw
庐山谣	ymye
卢尚书	hinn
禄仕当随牒	pwit
露湿晴花春殿香	fijt
鲁收	qgnh
渌水荡漾清猿啼	iiak
渌水净素月	iiue
卢思道	hlut
录调	viym
卢文纪	hyxn
卢渥	hnin
鲁无君子者	qfvf
卢象	hnqj
炉香闲袅凤凰儿	otuq
卢携	hnrw
卢延让	htyh
卢殷	hnrv
路远不可测	kfgi
陆蕴	bfax
禄在其中矣	pdac
卢肇	hnyn
卢照邻	hjwy
卢真	hnfh
卢贞	hnhm
虏阵横北荒	hbsa
卢征	hntg
露重飞难进	ftnf
卢注	hniy
陆子	bfbb
卢僎	hnwn
乱蝉衰草小池塘	tjyf
鸾刀缕切空纷纶	yvxx
乱定几年归	tpmj
鸾镜鸳衾两断肠	yqqe
栾清	yoig
乱入池中看不见	ttim
乱山残雪夜	tmgy
乱山来蜀道	tmgu
鸾翔凤翥众仙下	yumg
乱烟笼碧砌	totd
銮舆迥出千门柳	ywms
乱云低薄暮	tfwa
乱云飞渡仍从容	tfnp
略陈固陋	lblb
略考其行事	lfag
略输文采	llye
论功还欲请长缨	yagx
论画以形似	ygnw
论诗匡鼎来	yyag
轮台城北旄头落	lcfa
轮台城头夜吹角	lcfq
轮台子	lcbb
论心何必先同调	ynwy
伦与物忘	wgty
落笔超群英	atfa
骆宾王	cpgg
洛城一别四千里	ifgj
罗椿	lqsd
落帆逗淮镇	amgq
罗敷媚	lgvn
罗浮山下梅花村	lims
罗浮山下四时春	limd
罗唝曲	lkma
落花飞	aanu
落花飞雪何茫茫	aana
落花寂寂委青苔	aapa
落花狼藉酒阑珊	aaqg
落花落	aaai
落花如风吹	aavk
落花如有意	aavu
落花时节读华章	aaju
落花踏尽游何处	aakt
落花盈我衣	aaey
落花犹似堕楼人	aaqw
落花逐流水	aaei
罗荐春香暖不知	ladt
罗炯	lqom
骆浚	ctic
罗立言	luyy
珞珞如石	ggvd
落梅风	asmq
罗虬	lqjn
罗让	lqyh
落日楼台一笛风	ajsm
落日满秋山	ajim
落日平台上	ajgh
落日平原秋草中	ajgk
落日五湖春	ajgd
落日芜湖色	ajaq
落日心犹壮	ajnu
落日绣帘卷	ajxu
落日忆山中	ajnk
落日照大旗	ajjy
罗绍威	lxdg
络丝娘	xxvy
逻娑沙尘哀怨生	liit
罗泰	lqdw
络纬秋啼金井阑	xxtu
罗帷舒卷	lmwu
罗帷送上七香车	lmul
罗惜惜	lnna
罗珦	lqgt
罗袖动香香不已	lpfn
洛阳城东桃李花	ibfa
洛阳春	ibdw
洛阳东风几时来	ibag
洛阳访才子	ibyb
洛阳陌	ibbd
洛阳女	ibvv
洛阳女儿对门居	ibvn
洛阳女儿惜颜色	ibvq
洛阳女儿行	ibvt
罗邺	lqog
落叶聚还散	akba
落叶满阶红不扫	akir
落叶满空山	akim
落叶秋风早	aktj
落叶人何在	akwd
落叶他乡树	akws
落叶添薪仰古槐	akis
罗衣一此鉴	lygj
罗衣欲换更添香	lywt
罗隐	lqbq
落月	aiee
落月满屋梁	aeii
罗织红纱	lxxx
吕本中	kskh
绿窗明月在	xpjd
旅馆寒灯独不眠	yqph
旅馆无良伴	yqfw
绿槐高柳咽新蝉	xsyj
吕价	kkww
吕炅	kkjo
屡貌寻常行路人	nevw
旅美学者	yuif
吕牧	kktr
吕南公	kfwc
率疲弊之卒	yuuy
绿蒲向堪把	xatr
闾丘晓	urja
吕群	kkvt
吕让	kkyh
绿树青苔半夕阳	xsgb
绿水环绕	xigx
绿水青山枉自多	xigq
绿水绕飞阁	xixu
绿水人家绕	xiwx
旅宿	ytpw
吕同老	kmft
吕渭	kkil
吕渭老	kift
吕温	kkij
吕希纯	kqxg
绿兮衣兮	xwyw
绿烟灭尽清辉发	xogn
旅雁向南飞	ydtn
绿杨结烟垂袅风	xsxm
绿杨树下养精神	xssp
绿杨枝外尽汀洲	xssi
绿腰	xves
旅夜书怀	yynn
绿意	xvuj
吕颐浩	kait
虑以下人	hngw
侣鱼虾而友麋鹿	wqjy
绿云扰扰	xfrr
屡憎于人	nngw
旅枕梦残	yssg
履至尊而制六合	nguw
绿竹青青	xtgg
绿竹入幽径	xttt
绿竹猗猗	xtqq
马不进也	cgfb
马戴	cnfa
马逢	cntd
马怀素	cngx
麻郎儿	yyqt
马令	cnwy
马鸣风萧萧	ckma
马上黄金鞍	chaa
马首向何处	cutt
马踏春泥半是花	ckda
马蹄声碎	ckfd
马天骥	cgcu
马廷鸾	ctyo
马衔边地雪	ctlf
马湘	cnis
马萧萧	caav
麻鞋见天子	yamb
马乂	cn
马异	cnna
马邑龙堆路几千	ckdt
麻衣如雪	yyvf
麻衣如雪一枝梅	yyvs
蚂蚁缘槐夸大国	jjxl
马彧	cnak
马致恭	cgaw
马周	cnmf
马子严	cbgo
迈陂塘	dbfy
埋骨何须桑梓地	fmwf
卖花声	fafn
麦秀两岐	gtgm
满朝欢	ifcq
满川风月替人愁	ikmt
满地芦花和我老	ifaf
漫江碧透	iigt
满江天	iigd
满街狼犬	itqd
缦立远视	xufp
慢令致期谓之贼	nwgm
满龙堆	idfw
满路花	ikaw
漫漫轻云露月光	iili
满目悲生事	ihdg
漫天皆白	igxr
满庭花	iyaw
满庭霜	iyfs
满眼蓬蒿共一丘	ihar
满院春	ibdw
满园花	ilaw
满园深浅色	iliq
满座顽云拨不开	iyfg
莽昆仑	ajwx
忙里偷闲得几回	njwl
茫茫大梦中	aadk
茫茫江汉上	aaih
茫茫九派流中国	aavl
茫茫漫漫方自悲	aaid
芒芒然归	aaqj
茫茫天地间	aagu
莽莽万重山	aadm
氓之蚩蚩	ypbb
毛斑斑	tggy
毛并	tfua
貌恭而不心服	eade
茂陵不见封侯印	abgq
旄丘	ytrg
茅亭宿花影	aypj
毛文锡	tyqj
茅屋访孤僧	anyw
毛熙震	tafd
毛血洒平芜	ttia
毛泽东	tiai
美成在久	uddq
梅窗	stpw
眉黛夺将萱草色	nwdq
梅动雪前香	sfft
没蕃故人	iadw
眉峰碧	nmgr
美服患人指	uekr
梅花词	sayn
梅花欢喜漫天雪	sacf
梅花句	saqk
梅花开尽百花开	sagg
梅花满枝空断肠	saie
梅花年后多	sarq
梅花引	saxh
梅娇	stvt
美酒成都堪送老	uidf
美酒聊共挥	uibr
美酒一杯声一曲	uigm
没来由	igmh
梅岭三章	smdu
没马蹄	ickh
昧昧我思之	jjtp
眉目艳皎月	nhde
每念斯耻	twab
眉娘	nhvy
梅弄影	sgjy
梅坡	stfh
美人病来遮面	uwud
美人春	uwdw
美人胡为隔秋水	uwdi
美人结长恨	uwxn
美人娟娟隔秋水	uwvi
美人卷珠帘	uwup
美人清江畔	uwil
美人如花隔云端	uwvu
美人天上落	uwga
美人兮美人	uwww
美人相并立琼轩	uwsl
美人在时花满堂	uwdi
美人折向庭前过	uwrf
美人之贻	uwpm
每日报平安	tjrp
每日江头尽醉归	tjij
美如玉	uvgy
梅蕊腊前破	saed
梅圣俞诗集序	scwy
媒妁之言	vvpy
每岁烟花一万重	tmot
莓苔见履痕	aamu
美无度	ufya
每下愈况	tgwu
梅雪飘裙	sfsp
媚眼惟看宿鹭窠	vhnp
每有良朋	tdye
梅月圆	selk
每至夕照低阴	tgqb
每至于族	tggy
每逐青溪水	tegi
梅子欲尝新	sbwu
门对浙江潮	ucii
门径俯清溪	utwi
门临古陂曲	ujdm
门前迟行迹	uuny
门前冷落车马稀	uuut
门前万竿竹	uudt
门前学种先生柳	uuis
门人问曰	uwuj
扪参历井仰胁息	rcdt
门外韩擒虎	uqfh
门系钓鱼船	utqt
孟翱	blrd
孟宾于	bpgf
孟迟	blny
梦到故园多少路	sgdk
梦芙蓉	saap
梦魂不到关山难	sfgc
梦魂香	sftj
孟简	bltu
梦江口	sikk
猛将清九垓	quif
猛将腰间大羽箭	quet
孟郊	bluq
梦井	ssfj
孟敬子问之	babp
梦李白二首之二	ssrf
梦李白二首之一	ssrg
朦胧树色隐昭阳	eesb
孟启	blyn
孟球	blgf
孟守	blpf
猛兽不据	qugr
孟孙问孝于我	bbut
梦为远别啼难唤	syfk
孟武伯问孝	bgwf
梦仙游	swiy
孟翔	blud
梦行云	stfc
梦扬州	sryt
孟懿子问孝	bfbf
梦饮酒者	sqif
梦游天姥吟留别	sigk
孟云卿	bfqt
梦泽悲风动白茅	sida
孟之反不伐	bprw
孟子对曰	bbcj
孟子见梁襄王	bbmg
孟子将朝王	bbug
孟子去齐	bbfy
孟子谓齐宣王曰	bbyj
宓妃留枕魏王才	pvqf
猕猴骑土牛	qqcr
迷花不事君	oagv
迷花倚石忽已暝	oawj
弥勒真弥勒	xafa
靡使归聘	ywjb
靡室劳矣	ypac
米粟非不多也	osdb
密锁重关掩绿苔	pqta
密陀僧	pbwu
迷仙引	owxh
迷阳迷阳	obob
密叶罗青烟	pklo
密叶隐歌鸟	pkbq
靡有朝矣	ydfc
靡有孑遗	ydbk
米友仁	odwf
密雨斜侵薜荔墙	pfwf
密州上元	pyhf
缅伯高	xwym
绵绵蛮蛮如有情	xxyn
绵绵若存	xxad
面前明	duje
面如玉	dvgy
眠沙卧水自成群	hiav
眠时忆问醒时事	hjng
沔水	igii
免于刑戮	qggn
渺沧海之一粟	iiis
苗发	alnt
藐姑射之山	avtm
苗晋卿	agqt
渺渺没孤鸿	iiii
渺渺兮予怀	iiwn
邈然不可攀	eqgs
庙堂无策可平戎	yifa
妙舞此曲神扬扬	vrhr
苗则槁矣	amsc
妙湛总持不动尊	viuu
灭六国者	gulf
灭烛怜光满	goni
民德归厚矣	ntjc
民复孝慈	ntfu
民国奇耻	nldb
民具尔瞻	nhqh
民利百倍	ntdw
黾勉空仰止	kqph
黾勉求之	kqfp
黾勉同心	kqmn
民如野鹿	nvjy
民散久矣	naqc
民斯为下矣	nayc
民无能名焉	nfcg
民无所定	nfrp
民无信不立	nfwu
民鲜久矣	nqqc
民心不乱	nngt
民亦乐其乐	nyqq
敏以求之者也	tnfb
民亦忧其忧	nynn
民有饥色	ndqq
悯馀	nuqn
敏于事而慎于言	tggy
敏则有功	tmda
民之从事	npwg
民之难治	npci
民之失德	nprt
民主共和	nyat
民族阵线	nybx
明白畅达	jrjd
明白四达	jrld
命不可变	wgsy
名不虚传	qghw
鸣蝉更乱行人耳	kjgb
明朝挂帆席	jfry
明朝望乡处	jfyt
明朝驿使发	jfcn
明朝有封事	jfdg
明朝游上苑	jfia
明朝元会日	jffj
名成八阵图	qdwl
明耻篇	jbty
明道若昧	juaj
明断自天启	joty
明发不寐	jngp
名花倾国两相欢	qawc
鸣机夜课图记	ksyy
明君制民之产	jvru
冥吏	pjgk
螟蛉有子	jjdb
命令昨颁	wwjw
冥冥孤高多烈风	ppbm
冥冥花正开	ppag
冥冥九疑葬	ppva
冥冥鸟去迟	ppqn
冥冥日沉夕	ppjq
冥冥日沈夕	ppjq
明眸皓齿今何在	jhrd
明年春色倍还人	jrdw
明年花开复谁在	jrad
明年花开时	jraj
明年秋	jrto
明年谁此凭栏干	jryf
名岂文章著	qmya
明日巴陵道	jjcu
明日隔山岳	jjbr
明日黄花蝶也愁	jjat
明日落花飞絮	jjav
明日岁华新	jjmu
明日遂行	jjut
明日又逢春	jjcd
命如南山石	wvfd
明时思解愠	jjln
名殊体不殊	qgwg
命随年欲尽	wbrn
鸣梭	kqsc
明我长相忆	jttn
明星荧荧	jjaa
名亦既有	qyvd
明以教我	jnft
名与身孰亲	qgtu
名余曰正则兮	qwjw
明月半墙	jeuf
明月不归沉碧海	jegi
明月出海底	jeby
明月出天山	jebm
明月何曾是两乡	jewx
明月皎皎入华池	jeri
明月流光	jeii
明月落谁家	jeap
明月明年何处看	jejr
命曰琵琶行	wjgt
明月前溪后溪	jeui
明月斜	jewt
明月引	jexh
明月隐高树	jebs
明月棹孤舟	jest
明月直入	jeft
明月逐来	jeeg
明月逐人来	jeeg
鸣噪自纷纷	kktx
明朝有意抱琴来	jfdg
鸣筝金粟柱	ktqs
命之行也	wptb
缪氏子	xqbb
莫不静好	aggv
莫不中音	agku
墨池记	liyn
莫大乎尊亲	adtu
莫大于海	adgi
莫待春风总吹却	atdf
莫待无花空折枝	atfs
莫待晓风吹	atjk
莫道君行早	auvj
莫道昆明池水浅	auji
磨刀向猪羊	yvtu
莫得同车归	atmj
磨而不磷	ydgd
莫非自己	adtn
莫恨黄花未吐	anak
莫己知也	antb
莫嫁如兄夫	avvf
莫见长安行乐处	amtt
磨剑莫磨锥	ywaq
莫将边地比京都	aulf
莫将孤月对猿愁	aubt
莫教踏碎琼瑶	afkg
莫教枝上啼	afsk
莫令事不举	awgi
莫买沃洲山	anim
莫谩愁沽酒	ayti
莫蒙	ajap
漠漠帆来重	iimt
脉脉广川流	eeyi
漠漠水田飞白鹭	iiik
莫逆于心	augn
莫遣佳期更后期	akwa
莫遣沙场匹马还	akig
莫然无魂	aqff
莫如兄弟	avku
莫若以明	aanj
陌上花	bhaw
陌上花开蝴蝶飞	bhan
陌上看花人	bhrw
陌上郎	bhyv
陌上桑	bhcc
陌上相逢讵相识	bhsy
没身不殆	itgg
莫是藁砧归	ajaj
莫使金尊空对月	awqe
莫使金樽空对月	awqe
莫思归	aljv
莫思身外无穷事	altg
莫损愁眉与细腰	arte
莫叹韶华容易逝	akur
莫慰母心	anxn
莫为轻阴便拟归	aylj
莫我肯德	atht
莫我肯顾	athd
莫我肯劳	atha
莫我知也夫	attf
莫吾犹人也	agqb
莫嫌旧日云中守	avhp
莫嫌荦确坡头路	avak
莫向临邛去	atjf
莫宣卿	apqt
莫学武陵人	aigw
莫学游侠儿	aiiq
磨牙吮血	yakt
莫言朝花不复落	ayfa
莫言贫贱长可欺	aywa
莫言贫贱即可欺	aywa
莫厌伤多酒入唇	adwd
莫以今时宠	anwp
摸鱼子	rqbb
莫之敢指	apnr
末之难矣	gpcc
莫之能守	apcp
莫之能御也	apcb
莫知其极	atas
莫知其始	atav
莫知其所终	atax
莫知其他	ataw
莫之为而为者	apyf
莫知我哀	atty
莫之知避	aptn
莫之致而至者	apgf
莫之知载	aptf
磨锥成小利	yqdt
莫自使眼枯	atws
某两地	agfb
牟融	crgk
暮霭生深树	afts
目不能两视而明	hgcj
目不视恶色	hgpq
木不怨落于秋天	sgqg
暮从碧山下	awgg
暮隔千里情	abtn
穆护砂	trdi
沐皇恩	irld
暮婚晨告别	avjk
目尽长空闲	hntu
穆陵关北愁爱子	tbub
木落雁南渡	sadi
木落知寒近	satr
牧马频来去	tchf
木末芙蓉花	sgaa
暮年诗赋动江关	aryu
慕娉婷	avvy
暮禽相与还	awsg
暮秋独游曲江	atqi
暮去朝来淘不住	affw
暮惹御香归	aatj
暮色苍茫看劲松	aqas
暮上河阳桥	ahis
木声	ssfn
母氏劳苦	xqaa
母氏劬劳	xqqa
母氏圣善	xqcu
暮随肥马尘	abei
母孙二人	xbfw
牧童敲火牛砺角	tuyq
穆王何事不重来	tgwg
目无所见	hfrm
母兮鞠我	xwat
暮烟秋雨过枫桥	aots
木叶纷纷落	skxa
木叶萧萧	skaa
慕幽	ajxx
沐浴清化	iiiw
暮雨相呼失	afsr
目遇之而成色	hjpq
沐浴子	iibb
母曰	xgjh
暮云碧	afgr
暮云收尽溢清寒	afnp
睦州四韵	hylu
暮作吴宫妃	awkv
那得久	vtqy
哪个虫儿敢作	kwjw
那堪把剪刀	vfrv
那堪玄鬓影	vfyj
那闻旧人哭	vuhk
乃赋离骚	emyc
奈何今之人	dwww
奈何取之尽锱铢	dwbq
乃合天德	ewgt
奈何万乘之主	dwdy
奈何阻重深	dwbi
乃见狡童	emqu
乃见狂且	emqe
耐可乘流直上天	dstg
乃可以长生	esnt
乃令张良留谢	ewxy
乃凝于神	eugp
乃如左丘无目	evdh
乃生男子	etlb
乃是离之	ejyp
乃武乃文	egey
乃知兵者是凶器	etrk
乃知尔丑	etqn
乃中经首之会	ekxw
南北东西路	fuak
南朝民歌	ffns
难得之货	ctpw
南都行	fftf
男儿本自重横行	lqst
男儿到死心如铁	lqgq
男儿生身自有役	lqtt
男儿生世间	lqtu
男儿事长征	lqgt
男儿须读五车书	lqen
南方有鸟	fydq
南风入弦	fmtx
南歌子	fsbb
南宫适出	fptb
南冠客思侵	fppw
南国烽烟正十年	flor
南湖秋水夜无烟	fito
南极老人星	fsfj
南极老人应寿昌	fsfj
南菊再逢人卧病	fagu
南柯子	fsbb
赧郎明月夜	fyjy
南陵别儿童入京	fbky
南陵寓使迟	fbpn
南楼令	fswy
南溟夫人	fifw
男女并驾	lvul
男女居室	lvnp
南浦清江万里桥	fiis
南浦月	fiee
南取百越之地	fbdf
南取汉中	fbik
南人有言曰	fwdj
南容三复白圭	fpdf
南山崔崔	fmmm
南山归敝庐	fmjy
南山截竹为筚篥	fmft
南山居士	fmnf
南山烈烈	fmgg
南山新长凤凰雏	fmuq
南山有桑	fmdc
南山有台	fmdc
南山与秋色	fmgq
南山之下	fmpg
难忘旧日恩	cyhl
难为俗人言	cywy
难为俗人言也	cywb
南轩松	flsw
南雁归时更寂寥	fdjp
南有嘉鱼之什	fdfw
南有樛木	fdss
南枝向暖北枝寒	fstp
南卓	fmhj
男子千年志	lbtf
囊括经世道	grxu
囊括四海之意	grlu
曩者辱赐书	jfdn
囊中自有钱	gktq
哪吒令	kkwy
内家娇	mpvt
内立法度	muiy
内无怨女	mfqv
内省不疚	migu
馁在其中矣	qdac
能得几时好	ctmv
能复饮乎	ctqt
能胡歌	cdsk
能竭其力	cual
能近取譬	crbn
能如婴儿乎	cvmt
能使枉者直	cwsf
能体纯素	cwxg
能为雌乎	cyht
能无离乎	cfyt
能无为乎	cfyt
能无知乎	cftt
能行五者于天下	ctgg
能以礼让为国乎	cnpt
能者在职	cfdb
能知古始	ctdv
能致其身	cgat
霓裳一曲千峰上	figh
倪偁	wvwe
逆道违天	uufg
尼丘山	nrmm
泥上偶然留指爪	ihwr
霓裳羽衣	finy
泥他沽酒拔金钗	iwiq
拟托良媒益自伤	rryw
霓为衣兮风为马	fyyc
逆以煎我怀	unun
倪翼周	wnmf
泥拥奔蛇径	irdt
匿怨而友其人	aqdw
睨柱吞嬴	hsgy
年版	rhth
年大自疏隔	rdtb
碾雕白玉	dmrg
年共晓光新	raju
辇来于秦	fggd
念母劳家里	wxaj
年年今夜尽	rrwn
年年柳色	rrsq
年年岁岁一床书	rrmn
年年欲惜春	rrwd
年年越溪女	rrfv
年年战骨埋荒外	rrhq
念奴娇昆仑	wvvw
念奴娇鸟儿问答	wvvt
辇前才人带弓箭	fuft
念去去千里烟波	wffi
年深岂免有缺画	rimg
年始十八九	rvfv
念无与为乐者	wfgf
念香衾	wtwy
念与世间辞	wgat
年长色衰	rtqy
鸟度屏风里	qynj
鸟儿问答	qqut
鸟飞不到吴天长	qngt
鸟归沙有迹	qjiy
鸟尽良弓藏	qnya
鸟鸣涧	qkiu
鸟鸣嘤嘤	qkkk
袅袅秋风生	qqtt
鸟兽不可与同群	qugv
鸟鼠攸去	qvwf
鸟向平芜远近	qtgr
鸟亦罢其鸣	qylk
涅而不缁	idgx
蹑履相逢迎	knsq
聂胜琼	begy
蹑足行伍之间	kktu
凝碧池头奏管弦	ugix
宁化	pswx
凝绝不通声渐歇	uxgj
宁莫之知	papt
凝情自悄然	untq
宁生而曳尾涂中	ptdk
宁同万死碎绮翼	pmdn
宁为鸡口	pyck
宁武子	pgbb
宁知草间人	ptaw
宁知晓向云间没	ptji
牛丛	rhww
牛郎欲问瘟神事	rywg
牛马四足	rclk
牛女年年渡	rvri
牛峤	rhmt
牛僧孺	rwbf
牛山何必独沾衣	rmwy
牛希济	rqiy
牛渚矶	ridm
牛渚西江夜	risy
侬道横江恶	wusg
弄篙莫溅水	gtai
弄花香满衣	gaty
弄花雨	gafg
秾丽今何在	tgwd
弄巧成拙	gadr
努力加餐饭	vllq
努力尽今夕	vlnq
驽马恋栈豆	vcyg
驽马十驾	vcfl
怒其臂以当车辙	vanl
暖带入春风	jgtm
诺诺复尔尔	yytq
女床无树不栖鸾	vyfy
女萝山鬼语相邀	vamr
女心伤悲	vnwd
女行无偏斜	vtfw
女也不爽	vbgd
女曰鸡鸣	vjck
女之耽兮	vpbw
女子今有行	vbwt
女子善怀	vbun
女子有行	vbdt
女子之祥	vbpp
偶然间	wquj
偶然值林叟	wqwv
偶似山林客	wwmp
偶相逢	wstd
欧阳宾	abpr
欧阳彬	abss
欧阳澈	abiy
欧阳瑾	abga
欧阳炯	abom
欧阳珣	abgq
欧阳詹	abqd
偶缘犹未忘多情	wxqn
偶值当途石	wwid
怕愁贪睡独开迟	ntwn
排歌	rdsk
徘徊庭树下	ttyg
徘徊于斗牛之间	ttgu
潘牥	ittr
盘根错节之既破	tsqd
攀桂仰天高	sswy
攀荷弄其珠	sagg
盘马弯弓惜不发	tcyn
潘孟阳	ibbj
磐石方且厚	tdyd
磐石无转移	tdft
判司卑官不堪说	unry
盘飧市远无兼味	tqyk
潘唐	ityv
潘图	itlt
潘熊飞	icnu
潘炎	itoo
潘雍	ityx
潘佑	itwd
潘岳悼亡犹费词	irny
庞德公	ytwc
庞籍	ydtd
庞蕴	ydax
庖丁释刀对曰	ystj
炮火连天	oolg
袍裤宫人扫御床	pppy
抛球乐	rgqi
庖人虽不治庖	ywky
抛绣球	rxgf
庖有肥肉	ydem
匏有苦叶	ddak
裴澈	djiy
陪臣执国命	barw
裴诚	djyd
裴达	djdp
裴迪	djmp
裴翻	djto
沛公安在	iwpd
沛公大惊	iwdn
沛公奉卮酒为寿	iwdd
沛公今事有急	iwwq
沛公居山东时	iwnj
沛公军霸上	iwph
沛公军在霸上	iwph
沛公默然	iwlq
沛公起如厕	iwfd
沛公已去	iwnf
沛公欲王关中	iwwk
沛公则置车骑	iwmc
裴光庭	diyt
裴航	djte
裴皞	djrr
裴潾	djio
裴略	djlt
沛然下雨	iqgf
裴淑	djih
裴说	djyu
裴湘	djis
裴铏	djqg
裴休	djws
裴谞	djyn
裴延	djth
裴瑶	djge
裴耀卿	diqt
配义与道	sygu
裴夷直	dgfh
佩玉将将	wguu
佩玉鸣鸾罢歌舞	wgkr
佩玉琼琚	wggg
佩玉之傩	wgpw
喷壑数十里	khoj
彭蟾	fkjq
朋党论	eiyw
彭芳远	fafq
捧剑仆	rwwh
蓬莱此去无多路	aahk
蓬莱阁	aaut
蓬莱宫阙对南山	aapm
蓬门未识绮罗香	auft
芃芃其麦	aaag
彭叔夏	fhdh
鹏抟九天	ervg
烹羊宰牛且为乐	yupq
朋友有信	eddw
朋友之馈	edpq
彭正大	fgdd
鹏之徙于南冥也	eptb
彭子翔	fbud
譬道之在天下	nupg
蚍蜉撼树谈何易	jjrj
霹雳一声暴动	ffgf
匹马西从天外归	acsj
琵琶行并序	ggty
琵琶一曲肠堪断	gggo
皮日休	hjws
譬如北辰	nvud
譬如平地	nvgf
譬如为山	nvym
否泰如天地	gdvf
披帷西向立	rmsu
披香殿前花始红	rtnx
披衣更向门前望	rygy
披衣觉露滋	ryii
譬之宫墙	nppf
譬诸草木	nyas
譬诸小人	nyiw
偏到鸳鸯两字冰	wgqu
偏惊物候新	wntu
骗了无涯过客	cbfp
翩翩起舞	yyfr
偏其反而	ward
偏师借重黄公略	wjwl
片言可以折狱者	tysf
片云天共远	tfgf
偏在洛阳东	wdia
扁舟共济与君同	ytam
偏坐金鞍调白羽	wwqn
飘泊天涯	sigi
漂泊西南天地间	iisu
飘拂升天行	srtt
飘零君不知	sfvt
飘零事已空	sfgp
飘零随风	sfbm
缥缈孤鸿影	xxbj
飘飘何所似	ssww
飘萧松桂秋	sast
牝常以静胜牡	tint
贫村才数家	wsfp
贫而无怨难	wdfc
贫俭诚所尚	wwyi
贫贱夫妻百事哀	wmfy
贫贱江头自浣纱	wmix
贫贱有此女	wmdv
拼今生	rwtg
贫居依谷口	wnwk
拼了尽烛	rbno
品令	kkwy
频年不解兵	hrgr
贫女	wvvv
贫且贱焉	wemg
贫人见之	wwmp
贫也乐	wbqi
拼一醉	rgsg
平曾	guul
平陈与宋	gbgp
平淡无奇	gifd
屏风九叠云锦张	nmvx
屏风绝句	nmxq
屏风周昉画纤腰	nmme
凭割断愁思恨缕	wpox
凭君莫射南来雁	wvad
平明别我上山去	gjkf
平明吹笛大军行	gjkt
平明闾巷扫花开	gjug
平明每幸长生殿	gjtn
平明骑马入宫门	gjcu
娉娉袅袅十三余	vvqw
平平平	gggu
平平平平	gggg
平平平平平	gggg
平平平平平平	gggg
平平平平平平平	gggg
平平平仄	gggd
平平平仄仄	gggd
平平平仄仄平平	gggg
平平仄	ggdw
平平仄仄平	ggdg
平平仄仄平平	ggdg
平平仄仄平平仄	ggdd
平平仄仄仄平	ggdg
平平仄仄仄平平	ggdg
平铺湘水流	gqii
平如镜面	gvqd
平沙浩浩四无边	giil
平沙列万幕	giga
平沙莽莽黄入天	giag
平沙日未没	giji
平沙万里绝人烟	gido
平生不下泪	gtgi
平生负奇节	gtqa
平生实爱才	gtpf
平生五千卷	gtgu
平生五色线	gtgx
平生一片心	gtgn
平生自有分	gttw
凭轩涕泗流	wlii
砯崖转石万壑雷	dmlf
平阳歌舞新承宠	gbsp
平野入青徐	gjtt
平易恬淡	gjni
平韵	guuj
平仄平	gdgu
平仄平平	gdgg
平仄平平平仄	gdgd
平仄平平平仄仄	gdgd
平仄平平仄	gdgd
平仄平平仄仄	gdgd
平仄平平仄仄平	gdgg
平仄仄	gddw
平仄仄平	gddg
平仄仄平平	gddg
平仄仄平平仄	gddd
平仄仄平平仄仄	gddd
平仄仄平仄	gddd
颇得清净理	htig
破笛	dhtm
婆罗门	iluy
婆罗门引	ilux
破帽多情却恋头	dmqu
破山寺后禅院	dmfb
破邵	dhvk
颇学阴何苦用心	hibn
破灶烧湿苇	dooa
破阵乐	dbqi
迫之如火煎	rpvu
破字令	dpwy
掊斗折衡	rurt
浦边风	ilmq
铺床拂席置羹饭	qyrq
扑粉蝶	roja
匍匐救之	qqfp
扑蝴蝶	rjja
仆窃不逊	wpgb
菩萨蛮大柏地	aayf
菩萨蛮黄鹤楼	aays
菩萨面	aadm
菩萨清凉月	aaie
朴散则为器	samk
浦树远含滋	isfi
葡萄浆	aauq
葡萄深碧	aaig
普天乐	ugqi
普天之下	ugpg
蒲苇一时纫	aagx
蒲宗孟	apbl
齐安郡后池绝句	ypvq
其安易持	apjr
淇奥	iatm
栖白	ssrr
七百里驱十五日	adjj
骑白象	crqj
齐必变食	ynyw
岂必局束为人鞿	mnna
其蔽也荡	aaba
其蔽也绞	aabx
其蔽也狂	aabq
其蔽也乱	aabt
其蔽也愚	aabj
其蔽也贼	aabm
气变而有形	rydg
岂不尔思	mgql
戚不敢言	dgny
其不可者拒之	agsp
岂不日戒	mgja
岂不如贼焉	mgvg
其不善者恶之	agup
岂不夙夜	mgmy
杞不足征也	sgkb
七层摩苍穹	anyp
栖蟾	ssjq
其出弥远	abxf
其出人也远矣	abwc
齐楚之精英	yspa
凄怆摧心肝	unre
其次不辱身	augt
其次辟地	aunf
其次辟色	aunq
其次辟言	auny
其次弱者	auxf
其从之也	awpb
其脆易泮	aeji
其德乃普	ateu
其德天杀	atgq
汽笛一声肠已断	itgo
绮殿千寻起	xntf
凄断百年身	uodt
期而后可	adrs
弃而违之	ydfp
奇峰出奇云	dmbf
祈父	pywq
其父攘羊	awru
岂敢定居	mnpn
岂敢反乎	mnrt
岂敢盘桓	mnts
齐歌空复情	yspn
其故何也	adwb
泣孤舟之嫠妇	ibtv
其广数千里	ayoj
其鬼不神	argp
齐国虽褊小	ylki
杞国无事忧天倾	slfw
岂好辩哉	mvuf
旗号镰刀斧头	ykqu
岂合令郎君	mwwv
其何如	awvk
其何伤于日月乎	awwt
其何以行之哉	awnf
起宏图	fplt
其后二年	arfr
其后六年	arur
其后也处	arbt
其后也悔	arbn
齐侯之子	ywpb
绮户	xdyn
齐浣	yjip
其黄而陨	aadb
其或继周者	aaxf
齐己	yjnn
骐骥一跃	ccgk
弃甲曳兵而走	yljf
其皆出于此乎	axbt
泣尽继以血	inxt
其进愈难	afwc
其精甚真	aoaf
其觉无忧	aifn
其觉也形开	aibg
起看天地色凄凉	frgu
其可怪也欤	asng
汔可小康	isiy
期可已矣	asnc
其可左右	asdd
其揆一也	argb
契阔谈宴	duyp
其乐只且	aqke
其丽不亿	aggw
绮丽不足珍	xggg
岂力能制敌欤	mlcg
戚里生昌胤	djtt
其里之富人见之	ajpp
七里之郭	ajpy
凄凉宝剑篇	uupt
凄凉犯	uuqt
其良人出	aywb
凄凉调	uuym
七律	agtv
七律到韶山	atgm
七律冬云	attf
骑驴渺渺入荒陂	ccib
其寐也魂交	apbu
其美者自美	aufu
其民淳淳	anii
其民缺缺	anrr
其名不去	aqgf
其鸣喈喈	akkk
其名为鲲	aqyq
其名为鹏	aqye
七年之内	arpm
七娘子	avbb
骑牛远远过前村	crfs
妻孥怪我在	gvnd
其泣喤喤	aikk
凄凄去亲爱	uufe
其寝不梦	apgs
凄清如许	uivy
其去不能止	afgh
崎岖不易行	mmgt
其曲中规	amkf
岂人	mnww
齐人伐燕	ywwa
其人甚远	awaf
岂人为	mwyl
其日固久	ajlq
其日牛马嘶	ajrk
其入不距	atgk
岂上望夫台	mhyc
其神不伤人	apgw
齐声唤	yfkq
棋声惊昼眠	sfnh
其生若浮	atai
其声呜呜然	afkq
其生也荣	atba
其生也天行	atbt
其生之时	atpj
其食不甘	awga
岂是池中物	mjit
七十老翁何所求	afff
气势两相高	rrgy
其使民也义	awny
其实七兮	apaw
其事上也敬	agha
其视下也	apgb
起视夜何其	fpya
其室则迩	apmq
七十者衣帛食肉	affm
其实之肴	appq
七十字	afpb
其孰能讥之乎	ayct
淇水汤汤	iiii
淇水滺滺	iiii
其谁知之	aytp
其舜也与	aebg
其斯而已矣	aadc
其死若休	agaw
其死也哀	agby
其死也物化	agbw
其斯之谓与	aapg
其所师	arjg
其他可能也	awsb
泣涕涟涟	iiii
泣涕如雨	iivf
岂忘二三子	myfb
其往欲何云	atwf
七围八围	alwl
其未得之也	aftb
其为惑也	ayab
其为气也	ayrb
岂为妻子谋	mygy
其为人也	aywb
其为仁之本与	aywg
其惟圣人乎	anct
其微易散	atja
其未兆易谋	afiy
其文漫灭	ayig
岂无膏沐	mfyi
起舞莲花剑	fraw
綦毋潜	axif
其无私德	aftt
岂无他士	mfwf
其无正也	afgb
其息深深	atii
七夕始言归	aqvj
七夕谁见同	aqym
气息奄奄	rtdd
其下不昧	aggj
其下平旷	aggj
其下维萚	agxa
其贤不及孔子	ajgb
岂羡王侯	mugw
其险也如此	abbh
岂向人间住	mtww
齐相杀之费二桃	ysqs
岂销铄	mqqq
其啸也歌	akbs
其心塞渊	anpi
其心以为不然者	annf
其心与之然	angq
其行己也恭	atna
其胸襟	aepu
岂虚言哉	mhyf
齐宣王问	ypgu
齐宣王问曰	ypgj
栖鸦归后	sajr
其言不让	aygy
七言古诗	aydy
七言绝句	ayxq
其言似不足者	aywf
其言也善	aybu
其言之不怍	aypn
七阳	agbj
其养民也惠	aung
其叶沃若	akia
期夜月	ayee
其叶蓁蓁	akaa
栖一	ssgg
其意常在沛公也	auib
岂伊地气暖	mwfj
期已久矣	anqc
其一人恶	agwg
其一人美	agwu
其翼若垂天之云	anaf
其仪一兮	awgw
其义一也	aygb
岂宜重问后庭花	mpta
其用不弊	aegu
其用不穷	aegp
岂有悔哉	mdnf
其由来	amgo
齐有孟尝	ydbi
其有所试矣	adrc
齐有倜傥生	ydwt
其犹橐龠乎	aqgt
岂有文章惊海内	mdym
其有夜旦之常	adyi
其由也与	ambg
七虞	agha
七遇	agjm
其愚不可及也	ajgb
其雨其雨	afaf
其于人也	agwb
岂余身之惮殃兮	mwtw
跂予望之	kcyp
起予者商也	fcfb
七月时	aejf
七月食瓜	aewr
七月在野	aedj
其在道也	adub
岂在多杀伤	mdqw
其在宗庙朝廷	adpt
其则不远	amgf
淇则有岸	imdm
欹枕江南烟雨	dsif
其政察察	agpp
其政闷闷	aguu
其正色邪	agqa
其争也君子	aqbb
气之大者也	rpdb
其知道乎	atut
气之聚也	rpbb
其知可及也	atsb
弃掷逦迤	yrgt
其知弥少	atxi
其直如矢	afvt
其制稍异于前	artu
气之帅也	rpjb
弃脂水也	yeib
其至矣乎	agct
其终也已	axbn
其中有精	akdo
其中有物	akdt
其中有象	akdq
其中有信	akdw
岂逐春风一一回	medl
乞诸其邻而与之	tyap
妻子好合	gbvw
其子七兮	abaw
其自视也	atpb
其作始也简	awvt
起坐鱼鸟间	fwqu
恰似十五女儿腰	nwfe
钱安安	qppv
千百里	tdjf
千变万化皆天机	tyds
前赤壁赋	ufnm
浅处无妨有卧龙	itfd
千春隔流水	tdbi
千村薜荔人遗矢	tsat
千村万落生荆杞	tsds
千二百轻鸾	tfdy
千古风流事	tdmg
谦光	yuiq
铅华不可弃	qwgy
千唤不一回	tkgl
千家山郭静朝晖	tpmj
千金裘	tqfi
千金一笑买倾城	tqgf
前军夜战洮河北	upyu
乾康	fjyv
迁客相看泪满衣	tpsy
乾坤水上萍	ffia
乾坤一腐儒	ffgw
乾坤展清眺	ffnh
千里冰封	tjuf
千里不留行	tjgt
千里共明月	tjae
千里佳期一夕休	tjww
千里江陵一日还	tjig
千里来寻故地	tjgf
千里其如何	tjaw
千里思	tjln
千里迢迢	tjvv
千里万里月明	tjdj
千里莺啼绿映江	tjai
千里照相思	tjjl
前路日将斜	ukjw
牵萝补茅屋	dapn
前年伐月支	urwf
千年调	trym
牵牛出河西	drbs
前辟四窗	unlp
钱起	qgfh
浅浅石溜泻	iidi
千秋二壮士	ttff
千秋功罪	ttal
千秋节	ttab
千秋万岁	ttdm
千秋万岁后	ttdr
千秋万岁名	ttdq
千取百焉	tbdg
前人田地后人收	uwln
千仞之高	twpy
千山响杜鹃	tmkk
褰裳	pfip
褰裳涉溱	piii
千乘之君	ttpv
千室之邑	tppk
千首诗轻万户侯	tuyw
遣谁听	kykr
前太守臣逵	udpf
前头捉了张辉瓒	uurg
千万不复全	tdgw
千万人之心也	tdwb
芊蔚何青青	aawg
钱信	qgwy
前行若无山	utam
钱珝	qg
千寻铁锁沈江底	tvqy
千岩万壑不辞劳	tmda
千岩万壑路不定	tmdp
千岩万转路不定	tmdp
前言戏之耳	uycb
牵衣顿足拦道哭	dygk
千营共一呼	taak
前缘竟何似	uxuw
千载落风尘	tfai
千载琵琶作胡语	tfgy
千载谢东风	tfym
浅则揭	imrj
千杖敲铿羯鼓催	tsyw
强国请服	xlye
枪急万人呼	sqdk
将进酒	ufis
将进酒杯莫停	ufiw
将进酒君莫停	ufiw
墙里佳人笑	fjwt
墙里秋千墙外道	fjtu
强梁者不得其死	xifg
枪林逼	ssgk
强虏灰飞烟灭	xhdg
羌戎贺劳旋	ualy
墙外行人	fqtw
蔷薇几度花	aama
强为之名曰大	xypd
强行者有志	xtff
强移栖息一枝安	xtsp
墙有茨	fdau
强欲从君无那老	xwwf
强欲登高去	xwwf
枪榆枋而止	sssh
憔悴也相关	nnbu
憔悴支离为忆君	nnfv
桥低乌鹊夜	swqy
桥回行欲断	slto
乔吉	tdfk
乔侃	tdwk
樵客初传汉姓名	sppq
乔牌儿	ttqt
桥欹绝涧中	sdxk
翘翘错薪	aaqa
樵人归欲尽	swjn
乔舜	tdep
巧笑人疑在	atwd
巧笑之瑳	atpg
巧言令色	aywq
巧言偏辞	aywt
巧言如簧	ayvt
乔知之	ttpp
巧啭岂能无本意	akmu
妾薄命	uawg
妾不堪驱使	ugfw
且持梦笔书奇景	ersj
妾当作蒲苇	uiwa
锲而舍之	qdwp
且尔言过矣	eqyc
妾发初覆额	unpp
且放白鹿青崖间	eyru
怯夫慕义	nfay
且夫天地之间	efgu
且负下未易居	eqgn
窃国者为诸侯	plfw
且何谓阁子也	ewyb
且教红粉相扶	efxr
且尽生前有限杯	ents
且尽手中杯	enrs
且就洞庭赊月色	eyiq
且看欲尽花经眼	erwh
且乐生前一杯酒	eqti
挈妻子而去之走	dgbf
切切故乡情	aadn
且如今年冬	evwt
妾身未分明	utfj
且适南冥也	etfb
妾似井底桃	uwfs
且随缘	ebxx
且往观乎	etct
窃为大王不取也	pydb
且为王孙立斯须	eyge
且为之奈何	eypw
窃闻天子已传位	pugw
妾心井中水	unfi
且须酣畅万古情	eesn
且以汝之有身也	enib
且以喜乐	enfq
且饮美酒登高楼	equs
妾有情	udng
且由他	emwb
妾有绣腰襦	udxp
且欲竟寻彭泽宰	ewup
且暂还家去	elgf
且知方也	etyb
妾住在横塘	uwdf
秦爱纷奢	dexd
秦川得及此间无	dktf
秦地可尽王也	dfsb
秦地罗敷女	dflv
琴调	ggym
琴调相思引	gysx
秦娥梦断秦楼月	dvse
亲而行之	udtp
勤而行之	adtp
亲而誉之	udip
琴歌	ggsk
秦皇岛外打鱼船	drqt
禽荒非所乐	wadq
秦皇扫六合	drrw
秦嘉	dwfk
秦楼月	dsee
亲朋无一字	uefp
秦人不暇自哀	dwgy
秦人开关延敌	dwgt
秦人视之	dwpp
秦桑低绿枝	dcws
琴瑟相思引	ggsx
琴瑟在御	ggdt
秦士录	dfvi
秦时与臣游	djgi
禽兽逼人	wugw
禽兽成群	wudv
螓首蛾眉	jujn
禽兽繁殖	wutg
琴台日暮云	gcjf
秦韬玉	dfgy
溱洧	idid
琴心三叠道初成	gndd
勤心养公姥	anuv
溱与洧	igid
沁园春长沙	ildi
秦湛	dwia
秦中自古帝王州	dkty
青霭入看无	gftf
倾白酒	wris
倾杯	wxsg
轻薄儿	laqt
轻薄桃花逐水流	lasi
轻薄为文哂未休	layw
清波引	iixh
庆长春	ytdw
请尝试之	yiyp
清晨再拜铺丹墀	ijgf
倾城最在著戎衣	wfjy
轻翅萦枝舞蝶来	lfag
清川带长薄	ikga
清川澹如此	ikih
青春不再来	gdgg
庆春宫	ydpk
青春留不住	gdqw
青春岂不惜	gdmn
青春虚度无所成	gdhd
庆春泽	ydic
青春作伴好还乡	gdwx
情词	ngyn
清词丽句必为邻	iygw
卿但暂还家	qwlp
卿当日胜贵	qijk
庆东原	yadr
青墩溪畔龙钟客	gfip
情多去未得	nqft
清风吹空月舒波	imki
青枫江上秋帆远	gsif
清风明月苦相思	imjl
清风明月无人管	imjt
青枫叶赤天雨霜	gskf
青哥儿	gsqt
清歌妙舞落花前	isvu
清光应更多	iiyq
清光犹为君	iiqv
晴光转绿苹	jila
青归柳叶新	gjsu
倾国倾城胜莫愁	wlwt
青海头	giud
清和风	itmq
情何限	nwbv
清淮奉使千馀里	iidj
青槐夹驰道	gsgu
清辉淡水木	iiis
清辉照衣裳	iiji
清江行	iitf
清江一曲抱村流	iigi
清静为天下正	igyg
情久长	nqta
请君为我侧耳听	yvyk
请看石上藤萝月	yrde
卿可去成婚	qsfv
顷刻兴亡过手	xyir
顷筐塈之	xtvp
青莲居士谪仙人	ganw
青绫被	gxpu
青陵台	gbck
清流	igiy
请留盘石上	yqth
青楼薄幸名	gsaq
青楼扑酒旗	gsry
青楼自管弦	gstx
请略陈固陋	ylbb
青萝拂行衣	gary
轻罗已薄未更衣	llny
青门种瓜人	gutw
青冥浩荡不见底	gpiy
清明几处有新烟	ijmo
清明即事	ijvg
清明日	ijjj
青泥何盘盘	giwt
青鸟不传云外信	gqgw
青鸟飞去衔红巾	gqnm
青鸟明丹心	gqjn
青牛白马七香车	grrl
青女不饶霜	gvgf
晴偏好	jwvb
轻颦双黛螺	lhcj
清平调	igym
清平调词三首	igyu
清平乐会昌	igqj
清平乐六盘山	igqm
清浅白石滩	iiri
庆千秋	ytto
情亲见君意	numu
庆清朝	yifj
庆清朝慢	yifn
庆青春	ygdw
青青夹御河	gggi
青青竹笋迎船出	ggtb
清秋幕府井梧寒	itap
清秋燕子故飞飞	itan
情人怨遥夜	nwqy
青箬笠绿蓑衣	gtty
清瑟怨遥夜	igqy
青山朝别暮还见	gmfm
青山澹吾虑	gmih
青山卷白云	gmuf
青山空复情	gmpn
青山空向人	gmpw
青山缭绕疑无路	gmxk
青山绿水共为邻	gmxw
青山明月不曾空	gmjp
青山明月梦中看	gmjr
青山湿遍	gmiy
青衫湿遍	gpiy
青山万里一孤舟	gmdt
青山望断河	gmyi
青山行不尽	gmtn
青山一道同云雨	gmgf
青山犹哭声	gmqf
青山着意化为桥	gmus
清商怨	iuqb
轻生一剑知	ltgt
青史古人空	gkdp
青史几行名姓	gkmv
清诗句句尽堪传	iyqw
请事斯语矣	ygac
清时有味是无能	ijdc
清水白石何离离	iiry
清泗与淮通	iigc
青松蔽日	gsaj
青松如膏沐	gsvi
青苔满阶砌	gaid
青天骑白龙	ggcd
青天无片云	ggff
青天削出金芙蓉	ggia
青天有月来几时	ggdj
清湍鸣回溪	iiki
轻纨细绮相追飞	lxxn
请往谓项伯	ytyw
清渭东流剑阁深	iiai
请问其目	yuah
青溪	geie
清溪清我心	iiin
清溪深不测	iiii
青霞断绛河	gfoi
清香更何用	itge
清心拂尘服	inre
清新庾开府	iuyy
青杏儿	gsqt
庆宣和	yptk
请循其本	ytas
青眼高歌惧未老	ghyf
清言见古今	iymw
青阳逼岁除	gbgb
清扬婉兮	irvw
清夜坠玄天	iybg
请以剑舞	ynwr
请以战喻	ynhk
轻阴阁小雨	lbuf
清远道士	ifuf
清月出岭光入扉	ieby
卿云	qtfc
青云当自致	gfig
青云少年子	gfib
轻云微月	lfte
青云羡鸟飞	gfun
青云怨	gfqb
顷在黄州	xday
轻则失根	lmrs
青冢黄昏路	gpak
轻舟去何疾	ltfu
请奏鸣琴广陵客	ydkp
穷兵黩武今如此	prlh
穷愁千万端	pttu
穷发之北	pnpu
琼楼玉宇	gsgp
穷年忧黎元	prnf
琼台	gyck
穷巷牛羊归	parj
穷亦不足悲	pygd
琼珠碎却圆	ggdl
秋边一雁声	tlgf
丘不与易也	rggb
秋草独寻人去后	taqr
秋蝉疏引	tjnx
秋池不自冷	tigu
秋丛绕舍似陶家	twxp
丘丹	rgmy
秋登兰山寄张五	twug
秋风不相待	tmgt
秋风忽忆江东行	tmqt
秋风惊绿	tmnx
秋风卷入小单于	tmug
秋风清	tmig
秋风走马出咸阳	tmfb
秋歌	tosk
秋光满目	tiih
秋毫不敢有所近	tygr
秋河隔在数峰西	tibs
秋荷一滴露	tagf
秋花落更迟	taan
秋花冒绿水	taji
秋槐叶落空宫里	tskj
秋江碧入吴	tigk
秋尽江南草木凋	tniu
秋景丽	tjgm
秋菊能傲霜	tacf
秋空明月悬	tpje
秋来处处割愁肠	tgte
秋来南向飞	tgfn
秋来未著花	tgfa
秋来相顾尚飘蓬	tgsa
丘峦崩摧	rymr
秋梦不归家	tsgp
秋浦歌十七首	tisu
秋浦途中	tiwk
求其友声	fadf
秋千期约	ttax
秋千索	ttfp
求仁而得仁	fwdw
秋日望乡心	tjyn
秋蕊香	tatj
求若所欲	farw
秋色从西来	tqwg
秋色横空	tqsp
秋色老梧桐	tqfs
秋色无远近	tqfr
秋色有佳兴	tqdi
秋山又几重	tmct
秋声不可闻	tfgu
秋声万户竹	tfdt
秋收时节暮云愁	tnjt
秋水	toii
秋水秋天生夕风	titm
秋水日潺湲	tiji
秋水为神玉为骨	tiym
丘说	rgyu
秋思冬愁春恨望	tlty
秋思耗	tldi
秋思夜	tlyw
丘为	rgyl
邱为	rgyl
求为可知也	fysb
求我庶士	ftyf
秋下荆门	tgau
秋宵吟	tpkw
秋宵月色胜春宵	tpep
秋宵月下有怀	tpen
虬须虎眉仍大颡	jehc
秋雁又南回	tdcl
秋夜长	tyta
秋夜寄邱员外	typq
求也为之	fbyp
秋夜雨	tyfg
丘亦耻之	rybp
秋以为期	tnya
秋雨晴时泪不晴	tfjj
丘悦	rgnu
秋月明	teje
秋月夜	teyw
秋云暗几重	tfjt
求者遍山隅	ffyb
丘之不得济也	rpgb
求之不得心常爱	fpge
求之不可得	fpgt
丘中有麻	rkdy
曲罢曾教善才服	mlue
曲罢悯然	mlnq
曲岛苍茫接翠微	mqat
驱儿罗酒浆	cqlu
曲肱而枕之	medp
去郭轩楹敞	fyli
渠会永无缘	iwyx
曲尽河星稀	mnit
曲尽已忘情	mnnn
去来固无迹	fgly
曲阑干	mufg
驱马出关门	ccbu
驱马复归来	cctg
驱马悠悠	ccww
去年花里逢君别	frak
去年人到今年老	frwf
去年相送	frsu
屈平词赋悬日月	ngye
曲千秋	mtto
去去不足观	ffgc
去去复去去	fftf
曲曲如屏	mmvn
去去思君深	ffli
去日儿童皆长大	fjqd
曲入冥	mtpj
取瑟而歌	bgds
去世法舟轻	fail
去时冠剑是丁年	fjpr
去时里正与裹头	fjju
瞿塘峡口冷烟低	hfmw
瞿塘滟预堆	hfif
取天下常以无事	bggg
趣途无百里	fwfj
臞翁	ehwc
去吴中	fkkh
驱烟寻涧户	covy
区以别矣	ankc
去以六月息者也	fnub
屈原	nbdr
屈原放逐	ndye
屈原离骚	ndyc
曲则全者	mmwf
屈折礼乐	nrpq
取之无禁	bpfs
屈指西风几时来	nrsg
屈指行程二万	nrtd
屈指行程两万	nrtd
去住彼此无消息	fwtt
权德舆	stwf
犬吠水声中	dkik
泉壑带茅茨	rhga
劝金船	cqte
劝君酒	cvis
劝君莫拒杯	cvas
劝君莫惜金缕衣	cvay
劝君惜取少年时	cvnj
劝君终日酩酊醉	cvxs
全民有责	wndg
权审	scpj
泉声咽危石	rfkd
劝我识作石鼓歌	ctys
全无敌	wftd
权无染	sfiv
泉源在庭户	ridy
泉源在左	ridd
荃者所以在鱼	afrq
劝醉	clsg
却道	fcut
雀儿答道	iqtu
却顾所来径	fdrt
却怕有人知	fndt
鹊桥仙令	asww
却去闻秋风	ffum
阙然久不报	uqqr
鹊踏枝	aksf
阙题	uujg
却望青青巘	fygm
却下水晶帘	fgip
却嫌脂粉污颜色	fveq
却匈奴七百余里	fqvj
却疑春色在邻家	fxdp
却忆红楼半夜灯	fnxo
却与小姑别	fgik
缺月昏昏漏未央	reqm
却走马以粪	ffco
群捕鱼儿溪影中	vrqk
群雌粥粥	vhxx
群而不党	vdgi
群壑倏已暝	vhwj
群居终日	vnxj
群轻折轴	vlrl
群山万壑赴荆门	vmdu
逡巡而不敢进	cvdf
群彦今汪洋	vuwi
然此可为智者道	qhsu
然而不胜者	qdgf
然而不王者	qdgf
然而成败异变	qddy
然而未仁	qdfw
然后察之	qrpp
然后从而刑之	qrwp
然后践华为城	qrkf
然后君子	qrvb
然后请问	qryu
然后驱而之善	qrcu
然后人侮之	qrwp
然后杀之	qrqp
然后图南	qrlf
然后相携卧白云	qrsf
然后行事	qrtg
然后知长短	qrtt
然后知轻重	qrtt
然诺重	qytg
然秦以区区之地	qdnf
苒苒几盈虚	aamh
冉冉云	mmfc
然视其左右	qpad
然则何如	qmwv
然则师愈与	qmjg
然则一羽之不举	qmgi
绕地游	xfiy
绕弦风雨哀	xxmy
热风吹雨洒江天	rmkg
热泪欲零还住	riww
热烈浪漫	rgii
人百其身	wdat
人必知之	wntp
人不见	wgmq
人不堪其忧	wgfn
仁不能守之	wgcp
人不识	wgyk
人不厌其取	wgdb
人不厌其笑	wgdt
人不厌其言	wgdy
人不以善言为贤	wgnj
人初生	wptg
人处一焉	wtgg
人传郎在凤凰山	wwym
人淡淡	wiio
人道横江好	wusv
人得而诛之	wtdp
认得醉翁语	ytsy
忍而不能舍也	vdgb
人而不仁	wdgw
人而无恒	wdfn
人而无礼	wdfp
人而无情	wdfn
人而无止	wdfh
任翻	wtto
忍放花如雪	vyaf
人非生而知之者	wdtf
人分千里外	wwtq
人告之以有过	wtpf
忍更思量	vglj
人归暮雪时	wjaj
人归山郭暗	wjmj
任华	wtwx
人或为鱼鳖	wayu
人间没个安排处	wuit
人间如梦	wuvs
人间万事出艰辛	wudu
人间亦自有丹丘	wuyr
人间又见真乘黄	wuca
人将拒我	wurt
人将相食	wusw
人皆见之	wxmp
人皆苦炎热	wxar
人皆谓我毁明堂	wxyi
人皆为之	wxyp
人皆仰之	wxwp
人皆养子望聪明	wxuj
人皆有兄弟	wxdu
人皆知有用之用	wxte
人君当神器之重	wvit
人看隘若耶	wrbb
人来去	wgfc
忍泪吟	vikw
人怜直节生来瘦	wnfu
人六亿	wuwn
人民五亿不团圆	wngl
人命危浅	wwqi
人能弘道	wcxu
仁能守之	wcpp
人攀明月不可得	wsjt
人贫伤可怜	wwwn
人乞祭余骄妾妇	wtwv
人其舍诸	wawy
人情翻覆似波澜	wnti
人情已厌南中苦	wnna
纫秋兰以为佩	xtuw
人去紫台秋入塞	wfhp
荏苒荏苒瞻四海	aaai
人人亲其亲	wwuu
人日题诗寄草堂	wjji
人生本无事	wtsg
人生不得已	wtgn
人生不满百	wtgd
人生不如意	wtgu
人生不相见	wtgm
人生处万类	wtto
人生达命岂暇愁	wtdt
人生得意须尽欢	wttc
人生非金石	wtdd
人生感意气	wtdr
人生贵相知	wtkt
人生几何春已夏	wtmd
人生几何时	wtmj
人生交契无老少	wtui
人生结交在终始	wtxv
人生看得几清明	wtrj
人生难得相知心	wtcn
人生能几何	wtcw
人生飘忽百年内	wtsm
人生如草木	wtvs
人生如此自可乐	wtvq
人生如朝露	wtvf
人生实难	wtpc
人生天地间	wtgu
人生天地之间	wtgu
人生无处不青山	wtfm
人生无家别	wtfk
人生无离别	wtfk
人生易老天难老	wtjf
人生一世间	wtgu
人生有离合	wtdw
人生由命非由他	wtmw
人生有情泪沾臆	wtde
人生在世共如此	wtdh
人生在世间	wtdu
人生在世能几时	wtdj
任氏	wtqa
人事不可量	wggj
人事多错迕	wgqt
人世难逢开口笑	wact
人世死前唯有别	wagk
人世死前惟有别	wagk
人事音书漫寂寥	wgup
任士之所劳	wfpa
人谁感至精	wydo
人似秋鸿来有信	wwtw
人随流水东西	wbis
人随沙路向江村	wbis
人随雁落西风	wbdm
任他流水向人间	wwiu
人谓之不死	wypg
人无衣	wfye
任希古	wqdg
衽席之上	pyph
人行明镜中	wtjk
人行犹可复	wtqt
仁恤庶无尤	wnyd
壬戌之秋	tdpt
人烟寒橘柚	wops
人言真可畏	wyfl
任要	wtsv
人杳杳	wssj
仁义充塞	wyyp
人亦念其家	wywp
人以食为天	wnwg
人以为谄也	wnyb
人亦有言	wydy
仁义之端	wypu
人有病	wdug
人有恒言	wdny
人游月边去	wief
仁远乎哉	wftf
人猿相揖别	wqsk
人月圆	welk
人在楼上	wdsh
人在木兰舟	wdst
仁在其中矣	wdac
仁者安仁	wfpw
仁者必有勇	wfnc
仁者播其惠	wfrg
仁者如射	wfvt
人至不去	wggf
人之不善	wpgu
仁之端也	wpub
人之过也	wpfb
人之好我	wpvt
人之将死	wpug
人之君子	wpvb
人之生也	wptb
人之生也直	wptf
人之所恶	wprg
人之所教	wprf
人之所美也	wprb
人之所畏	wprl
人之所欲	wprw
人之所欲也	wprb
人之无良	wpfy
人之言曰	wpyj
人之正路也	wpgb
人自伤心水自流	wtwi
人卒九州	wyvy
任醉	wtsg
日本晁卿辞帝都	jsjf
日迟迟	jnny
日初出	jpbm
日出雾露馀	jbfq
日出行	jbtf
日出有曜	jbdj
日出云中鸡犬喧	jbfk
日出在东方	jbdy
日出正东峰	jbgm
日啖荔支三百颗	jkaj
日复日	jtjj
日光随意落	jiba
日光斜照集灵台	jiwc
日过午已昏	jftq
日居月诸	jney
日见孤峰水上浮	jmbi
日脚下平地	jegf
日轮当午凝不去	jlif
日落长沙秋色远	jatf
日落江湖白	jair
日落山水静	jamg
日落西山暮	jasa
日落香车入	jatt
日暮长江里	jatj
日暮待情人	jatw
日暮东风怨啼鸟	jaaq
日暮复何之	jatp
日暮聊为梁父吟	jabk
日暮秋风起	jatf
日暮掩柴扉	jary
日暮倚修竹	jawt
日暮征帆何处泊	jati
日破云涛万里红	jdfx
日日采莲去	jjef
日日春光斗日光	jjdi
日日骑马来山中	jjck
日日醉如泥	jjsi
日色才临仙掌动	jqff
日色冷青松	jqus
日色已尽花含烟	jqno
日射纱窗风撼扉	jtxy
日晚江南望江北	jjiu
日夕怀空意	jqnu
日夕连秋声	jqlf
日夕望君抱琴至	jqyg
日夕依仁全羽翼	jqwn
日斜江上孤帆影	jwij
日晏犹得眠	jjqh
日夜东流人不知	jyat
日夜经过赵李家	jyxp
日夜随势行	jybt
日夜望将军至	jyyg
日益骄固	jucl
日已暮	jnaj
日影反照	jjrj
日用饮食	jeqw
日有食之	jdwp
日喻	jjkw
日羽肃天行	jnvt
日月出矣	jebc
日月忽其不淹兮	jeqw
日月笼中鸟	jetq
日月逝矣	jerc
日月照耀金银台	jejc
日凿一窍	jogp
日正当午	jgit
日知其所亡	jtay
日之夕矣	jpqc
日中见斗	jkmu
戎马关山北	acuu
戎马生于郊	actu
融融冶冶黄	ggua
容颜若飞电	puaj
荣諲	apys
戎昱	adju
容止顺其猷	phku
柔弱胜刚强	cxex
輮使之然也	lwpb
輮以为轮	lnyl
如不得已	vgtn
如不可求	vgsf
汝不知夫螳螂乎	igtt
汝诚人耶	iywb
如春登台	vdwc
如此江山	vhim
如此良人何	vhyw
如此至宝存岂多	vhgq
如得良友	vtyd
如得其情	vtan
如匪浣衣	vaiy
汝坟	ivfy
如逢故人	vtdw
如果细心的话	vjxy
如何肯到清秋日	vwhj
如何四纪为天子	vwlb
如翚斯飞	vnan
入火不热	togr
如火益热	vour
如或知尔	vatq
乳间股脚	euee
如今人方为刀俎	vwww
汝看此书时	irhj
如可赎兮	vsmw
如临深渊	vjii
如临于谷	vjgw
如履薄冰	vnau
如梦如梦	vsvs
如南山之寿	vfmd
如鸟斯革	vqaa
汝岂得自由	imtm
汝泣告我	iitt
如其礼乐	vapq
如泣如诉	vivy
汝其勿悲	iaqd
如千里	vtjf
如日月之食	vjew
如日月之食焉	vjeg
入塞	typf
如三岁兮	vdmw
如三月兮	vdew
如杀无道	vqfu
如山如河	vmvi
汝是大家子	ijdb
入蜀记	tlyn
入水不濡	tigi
如水益深	viui
如斯而已乎	vadt
如斯者	vaft
入宋	typs
如松茂矣	vsac
如啼眼	vkhv
如听万壑松	vkds
入潼关	tiud
汝为君子儒	iyvw
入我床下	ttyg
如五六十	vguf
入无穷之门	tfpu
如享太牢	vydp
如兄如弟	vkvu
乳燕飞	eanu
汝阳三斗始朝天	ibdg
如意令	vuwy
如婴儿之未孩	vmqb
如有博施于民	vdfn
如有复我者	vdtf
如有王者	vdgf
如有意	vduj
如有用我者	vdef
如欲平治天下	vwgg
如鱼水	vqii
如月在天	vedg
如月之恒	vepn
如在昨日	vdjj
入则事父兄	tmgk
如正人何	vgww
如之何其彻也	vpwb
如之何其废之	vpwp
如之何其可及也	vpwb
如之何勿思	vpwl
如之何则可	vpws
如知其非义	vtay
入之甚寒	tpap
如知为君之难也	vtyb
入之愈深	tpwi
汝知之乎	itpt
如竹苞矣	vtac
孺子孺子	bbbb
软草平莎过雨新	lagu
阮瑀	bfgt
阮阅	bfuu
瑞光千丈生白毫	gity
瑞鹤仙影	gpwj
芮辉	amiq
芮挺章	aruj
芮烨	amow
瑞云浓	gfip
瑞鹧鸪	gydq
蕊珠间	aguj
睿作尧君宝	hwap
润益	iuuw
润州城	iyfd
若白驹之过隙	arcb
若彼知之	attp
若存若亡	aday
若到越溪逢越女	agfv
若非巾柴车	adml
若非群玉山头见	advm
若夫乘天地之正	aftg
若负平生志	aqgf
若个是真梅	awjs
弱国入朝	xltf
若可寄天下	aspg
若可托天下	asrg
若烹小鲜	ayiq
若入前为寿	atud
若圣与仁	acgw
若是其甚与	ajag
若是晓珠明又定	ajjp
若属皆且为所虏	anxh
若望仆不相师	aywj
若为留得堂堂去	ayqf
若问使君才与术	auws
若无清风吹	afik
若无所归	afrj
若无罪而就死地	aflf
若信贝多真实语	awmy
若耶溪	abie
若耶溪傍采莲女	abiv
若耶溪边采莲女	abiv
若有人兮天一方	adwy
若臧武仲之知	adgt
弱者道之用	xfue
洒落出重云	iabf
飒飒东风细雨来	uuag
飒飒秋雨中	uutk
飒飒松上雨	uusf
飒爽英姿五尺枪	udas
飒沓如流星	uivj
洒向人间都是怨	itwq
塞姑	pfvd
塞马	pfcn
塞马一声嘶	pcgk
塞上曲	phma
赛神	pfpy
赛天香	pgtj
塞翁吟	pwkw
塞下曲六首	pgmu
塞垣春	pfdw
三百六十日	dduj
三杯拂剑舞秋月	dsre
三杯通大道	dscu
三杯吐然诺	dsky
三边曙色动危旌	dljy
三部乐	duqi
散步咏凉天	ahkg
三餐而反	dhdr
三春白雪归青冢	ddrp
三春三月忆三巴	dddc
三春行乐在谁边	ddtl
三春雁北飞	dddn
三登乐	dwqi
三冬足文史	dtkk
散而成章	addu
散发乘夕凉	antu
散发乘夜凉	antu
三分割据纡筹策	dwpt
三分天下有其二	dwgf
散关三尺雪	audf
三过其门而不入	dfat
三号而出	dkdb
三家者以雍彻	dpft
三绛	dgxt
三晋云山皆北向	dgft
三径苦无资	dtau
三军大呼阴山动	dpdf
三军过后尽开颜	dpfu
三里之城	djpf
三年奔走空皮骨	drdm
三年不出	drgb
三年不为乐	drgq
三年不言	drgy
三年笛里关山月	drte
三年多难更凭危	drqq
三年饥走荒山道	drqu
三年谪宦此栖迟	dryn
三年之后	drpr
三年之丧	drpf
三年之外	drpq
三平调	dgym
三千世界本无穷	dtap
三人成虎事多有	dwdd
三人相视而笑	dwst
三日不朝	djgf
三日不食	djgw
三日断五匹	djoa
三日而死	djdg
三日入厨下	djtg
三三五五映垂杨	ddgs
三山半落青天外	dmuq
三山十洞光玄箓	dmft
三上北高峰	dhum
三生石上结因缘	dtdx
三生同听一楼钟	dtmq
三十八年过去	dfwf
三事大夫	dgdf
三十而立	dfdu
三十六离宫	dfup
三十六年	dfur
三十六万人	dfuw
三十年来梦一场	dfrf
三世希不失矣	daqc
三十一年还旧国	dfgl
三岁贯女	dmxv
三岁食贫	dmww
三岁为妇	dmyv
三台春曲	dcdm
三台令	dcwy
三叹	dgkc
散天花	agaw
三万六千日	dduj
三围四围	dlll
三五七言	dgay
三五在东	dgda
三五之夜	dgpy
三峡楼台淹日月	dmse
三峡星河影动摇	dmjr
三湘愁鬓逢秋色	ditq
三湘衰鬓逢秋色	diyq
三谢不能餐	dygh
三星在户	djdy
三星在天	djdg
三星在隅	djdb
三嗅而作	dkdw
三学士	difg
三肴	dgqd
三夜频梦君	dyhv
三以天下让	dngy
三月不知肉味	degk
三月初五日	depj
三月聚粮	debo
三月三日天气新	dedu
三月时	dejf
三月雪连夜	defy
散则为死	amyg
三朝出入荣	dfba
三朝日	dfjj
三株媚	dsvn
三字令	dpwy
三子者出	dbfb
丧己于物	fngt
丧事不敢不勉	fggq
桑田碧海须臾改	clgn
桑田变沧海	clyi
桑条无叶土生烟	ctfo
丧致乎哀而止	fgth
桑之落矣	cpac
桑之未落	cpfa
桑中	cckh
扫地花	rfaw
扫地舞	rfrl
扫花游	raiy
嫂溺不援	vigr
搔首踟蹰	rukk
搔首赋归欤	rumg
色勃如也	qfvb
色静深松里	qgij
色厉而内荏	qdda
色取仁而行违	qbwf
瑟瑟罗裙金缕腰	ggle
色斯举矣	qaic
色庄者乎	qyft
僧伽歌	wwsk
僧贯休	wxws
僧皎然	wrqd
僧是愚氓犹可训	wjjy
僧言古壁佛画好	wydv
沙场烽火侵胡月	ifoe
纱窗日落渐黄昏	xpjq
杀盗非杀人	qudw
纱灯古殿深	xodi
杀鸡为黍而食之	qcyp
沙口石冻马蹄脱	ikde
杀戮到鸡狗	qngq
沙平水息声影绝	igix
杀气三时作阵云	qrdf
沙丘城下寄杜甫	irfg
杀人都市中	qwfk
杀人莫敢前	qwau
杀人如不能举	qwvi
杀人如剪草	qwva
杀人如麻	qwvy
杀人以梃与刃	qwnv
杀人亦有限	qwyb
杀人盈城	qwef
杀人之众	qwpw
沙塞子	ipbb
沙上草阁柳新暗	ihaj
沙上凫雏傍母眠	ihqh
杀生者不死	qtfg
沙头宿鹭联拳静	iupg
沙行渡头歇	itij
山爱夕阳时	meqj
善抱者不脱	urfe
扇裁月魄羞难掩	yfer
擅长行书	rttn
山城斜路杏花香	mfwt
山川满目泪沾衣	mkiy
山川其舍诸	mkay
山川萧条极边土	mkaf
山从人面起	mwwf
善贷且成	uwed
善刀而藏之	uvdp
山巅朱凤声嗷嗷	mmrk
山东今岁点行频	mawh
善复为妖	utyv
山高水深	myii
山光忽西落	miqa
山光物态弄春辉	miti
山鬼谣	mrye
山河风景元无异	mimn
山红涧碧纷烂漫	mxii
珊瑚碧树交枝柯	gggs
山花如绣颊	mavg
山际逢羽人	mbtw
山渐青	mige
善建者不拔	uvfr
山将落日去	muaf
善卷让天子	uuyb
山开旷望旋平陆	mgjb
山空鸟鼠秋	mpqt
山空松子落	mpsa
山口潜行始隈隩	mkib
山林二十年	msfr
山林作伴	msww
山路倒枯松	mkws
山暝听猿愁	mjkt
山南山北雪晴	mfmj
山青花欲燃	mgao
山鸲鹆	mqww
山泉散漫绕阶流	mrai
善人是富	uwjp
善人为邦百年	uwyr
善人之宝	uwpp
善人之资	uwpu
山色空濛雨亦奇	mqpd
山色遥连秦树晚	mqej
山山黄叶飞	mman
珊珊可爱	ggse
山上离宫宫上楼	mhys
山舍初成病乍轻	mwpl
善生	udtg
山石荦确行径微	mdat
善始善终	uvux
善始者实繁	uvft
善数不用筹策	uogt
山水多所得	miqt
山水空流山自闲	mipu
山水思微清	mili
山水有清音	midu
山寺钟鸣昼已昏	mfqq
山桃红	msxa
山头孤鹤向南飞	mubn
山头鼓角相闻	mufu
山外云	mqfc
善为我辞焉	uytg
山为樽	mysu
山下旌旗在望	mgyy
山下山下	mgmg
山衔好月来	mtvg
山县早休市	mejy
缮性何由熟	xnwy
善行无辙迹	utfy
山形依旧枕寒流	mgwi
山虚风落石	mhmd
善言无瑕谪	uyfy
善养生者	uutf
山意冲寒欲放梅	muus
山夷又纷然	mgcq
山阴道上桂花初	mbup
山阴道士如相见	mbum
善有果而已	udjn
山有木兮谷有泉	mdsr
山有枢	mdsa
山幽幽	mxxx
山雨初含霁	mfpf
山月随人归	mebj
山月照弹琴	mejg
山杂夏云多	mvdq
善珍	udgw
山镇西犯	mqsq
山中发红萼	mkna
山中尚含绿	mkix
山中无所有	mkfd
山中习静观朝槿	mkns
山中相送罢	mksl
山中一夜雨	mkgf
山中有流水	mkdi
山中与幽人对酌	mkgs
伤不实也	wgpb
上蔡苍鹰何足道	haau
伤春怨	wdqb
上德抚神运	htrf
尚德哉若人	itfw
上帝之风	hupm
上帝之声	hupf
上而不下	hdgg
上古有大椿者	hddf
上官仪	hpwy
上官昭容	hpjp
上国随缘住	hlbw
赏花时	iajf
上计轩辕	hyll
上江虹	hija
上将军居右	hupd
上尽重城更上楼	hnts
商君佐之	uvwp
上窥青天	hpgg
上林春	hsdw
上林春慢	hsdn
上林繁花照眼新	hstu
伤麟怨道穷	wyqp
伤灵修之数化	wvww
上留田行	hqlt
上略当分阃	hliu
上马娇	hcvt
尚寐无觉	ipfi
赏明月	ijee
上南平	hfgu
上平南	hgfm
上平声	hgfn
上清沦谪得归迟	hiin
伤情怨	wnqb
上如标枝	hvss
伤如之何	wvpw
上三峡	hdmg
上善若水任方圆	hual
商山四皓	umlr
汤汤流水	iiii
上失其道	hrau
上士闻道	hfuu
尚书固负若属耶	inlb
上束马	hgcn
上枢密韩太尉书	hspn
上耸忽如飞	hwqn
上堂拜阿母	hirx
赏玩夜忘归	igyj
上忘而下畔	hydl
商闻之矣	uupc
尚无位我生之后	ifwr
尚无庸	ifyv
上西楼	hsso
上西平	hsgu
上下交征利	hgut
尚想旧情怜婢仆	ishw
上小楼	hiso
伤心不独为悲秋	wngt
上行杯	htsg
尚颜	imut
上阳白发人	hbrw
上阳春	hbdw
商也不及	ubge
尚衣方进翠云裘	iyyf
上应美人意	hyuu
上有分流水	hdwi
上有好者	hdvf
上有可耕之田	hdsl
上有青冥之长天	hdgg
上有蔚蓝天	hdag
上有无花之古树	hdfs
上与浮云齐	hgiy
尚余孤瘦雪霜姿	iwbu
上元夫人	hffw
上圆下方	hlgy
上云乐	hfqi
商则	ummj
上之回	hplk
尚自露寒花未开	itfg
哨遍	kiyn
邵博	vkfg
少妇城南欲断肠	ivfe
少妇今春意	ivwu
稍共夜凉分	tayw
少孤为客早	ibyj
邵怀英	vnam
稍见市井喧	tmyk
邵景	vkjy
烧兰才作烛	oufo
少陵野老吞生哭	ibjk
少年不得志	irgf
少年负壮气	irqr
少年离别意非轻	iryl
少年上人号怀素	irhg
少年十五二十时	irfj
少年心	irny
少年子	irbb
少卿足下	iqkg
邵升	vkta
少时诵诗书	ijyn
邵士彦	vfut
少思寡欲	ilpw
少喜神仙术	ifps
烧香曲	otma
少小离乡老大回	iiyl
少小虽非投笔吏	iikg
少小幽燕客	iixp
稍逊风骚	tbmc
邵谒	vkyj
梢云良独难	sfyc
邵真	vkfh
少壮能几时	iucj
射不主皮	tgyh
奢侈荒淫	dwai
舍后且先	wret
摄乎大国之间	rtdu
舍己从人	wnww
社稷依明主	ptwy
社稷一戎衣	ptgy
舍酒去相语	wify
舍利弗	wtxj
舍南舍北皆春水	wfwi
舍南舍北皆种桃	wfws
摄齐升堂	ryti
射日弓	tjxn
舍瑟而作	wgdw
射杀山中白额虎	tqmh
舍生亦如此	wtyh
赦书一日行万里	fngj
摄提贞于孟陬兮	rrhw
舍我其谁也	wtab
麝熏微度绣芙蓉	ytta
奢则不孙	dmgb
舍正路而不由	wgkm
舍之则藏	wpma
谁会成生此意	ywdu
谁人曾与评说	ywuy
谁人更扫黄金台	ywgc
谁与	ywgn
甚爱必大费	aenx
申包惟恸哭	jqnk
沈伯文	iwyy
深不可识	igsy
深藏身与名	iatq
身长健	ttwv
沈长卿	itqt
沈传师	iwjg
身当恩遇常轻敌	tilt
神得一以灵	ptgv
身登青云梯	twgs
神鼎飞丹砂	phnd
深冬放火如红霞	ityf
沈东美	iaug
沈端节	iuab
身多疾病思田里	tquj
深耕易耨	idjd
深宫二十年	ipfr
神鬼神帝	prpu
参横斗转欲三更	csug
身后风流陌上花	trma
申欢	jhcq
神欢体自轻	pcwl
沈回	iplk
沈徽	iptm
沈晦	ipjt
神将来舍	pugw
身经百战曾百胜	txde
糁径杨花铺白毡	otst
深居俯夹城	inwf
沈郎多病不胜衣	iyqy
深柳读书堂	isyi
神妙独数江都王	pvqg
神莫大于化道	padu
慎莫近前丞相嗔	nark
深谋远虑	iyfh
神农之言	pppy
神女去已久	pvfq
神女生涯原是梦	pvts
神女应无恙	pvyu
身披六铢衣	truy
身骑白马万人中	tcrk
神气不变	prgy
沈千运	itfc
深秋帘幕千家雨	itpf
沈佺期	iwad
沈全期	iwad
神人无功	pwfa
沈如筠	ivtf
深山何处钟	imwq
深山夕照深秋雨	imqf
申申如也	jjvb
诜诜兮	yywg
慎氏	nfqa
身世悠悠何足问	tawu
沈叔安	ihpv
身死人手	tgwr
沈颂	ipwc
深邃博大	ipfd
身外即浮云	tqvf
沈蔚	ipan
身为贾人妇	tysv
身为天子	tygb
神无方	pfyy
慎勿为妇死	nqyg
慎勿违吾语	nqfy
神行令	ptwy
慎行其余	ntaw
身行万里半天下	ttdg
沈颜	iput
慎言其余	nyaw
沈腰潘鬓销磨	ieiy
深夜月当花	iyea
矧伊人矣	twwc
沈吟放拨插弦中	ikyk
神颖	pyxt
沈宇	ippg
身欲奋飞病在床	twdy
身与浮云无是非	tgid
身与货孰多	tgwq
甚于水火	agio
深院静	ibge
深院月	ibee
深院昼慵开	ibng
神赞	pytf
深则厉	imdd
神之去	ppfc
神之听之	ppkp
申之以孝悌之义	jpny
慎终追远	nxwf
深竹暗浮烟	itjo
沈紫曼	ihjl
神纵欲福难为功	pxwa
深坐蹙蛾眉	iwdn
深坐颦蛾眉	iwhn
胜败兵家事不期	emra
生别常恻恻	tkin
绳不直	xgfh
胜常	etip
圣朝无阙事	cffg
升沉不改故人情	tign
升沉应已定	tiyp
生刍一束	tqgg
圣代复元古	cwtd
圣代即今多雨露	cwvf
圣代无隐者	cwff
圣德北服南单于	ctug
盛德无我位	dtfw
声断续	foxf
胜而不美	edgu
生而弗有	tdxd
生而同声	tdmf
生而知之者上也	tdtb
声非加疾也	fdlb
笙歌醉梦间	tssu
生孩六月	tbue
生乎吾后	ttgr
生乎吾前	ttgu
生还偶然遂	tgwu
生活的磨难	tirc
升阶伛偻荐脯酒	tbwi
省吏	itgk
生离与死别	tygk
生男埋没随百草	tlfa
圣女祠	cvpy
生女犹得嫁比邻	tvqw
生女有所归	tvdj
升平乐	tgqi
圣人不出	cwgb
圣人不利己	cwgn
圣人不仁	cwgw
圣人不死	cwgg
圣人常无心	cwin
圣人成焉	cwdg
圣人存而不论	cwdy
生人但眠食	twww
圣人生焉	cwtg
圣人无常师	cwfj
圣人无名	cwfq
圣人已死	cwng
圣人用之	cwep
圣人在天下	cwdg
胜人者有力	ewfl
圣人之道	cwpu
圣人之道也	cwpb
圣人之德也	cwpb
圣人之所以为圣	cwpc
生人作死别	twwk
生入玉门关	ttgu
胜胜慢	eenj
绳绳兮	xxwg
绳绳兮不可名	xxwq
生生者不生	ttft
胜事空自知	egpt
生事且弥漫	tgei
生事如转蓬	tgva
生死不相离	tggy
胜似春光	ewdi
生死无虑	tgfh
胜似闲庭信步	ewuh
升堂坐阶新雨足	tiwk
生天生地	tgtf
圣王不作	cggw
声闻邻国	fuwl
圣文神武皇帝初	cypp
声闻于天	fugg
声闻于野	fugj
生我不得力	ttgl
生我劬劳	ttqa
圣无忧	cfnd
生小不相识	tigy
生小出野里	tibj
圣心备焉	cntg
圣心思贤才	cnlf
声喧乱石中	fktk
生涯共苦辛	tiau
生涯岂料承优诏	timy
生涯一片青山	tigm
生涯在镜中	tidk
生也死之徒	tbgt
声以动容	fnfp
胜因夙所宗	elmp
剩有离人影	tdyj
剩有游人处	tdit
圣则吾不能	cmgc
生长明妃尚有村	ttjs
生者为过客	tfyp
圣之和者也	cptb
声之寂寞	fppp
生之来不能却	tpgf
圣之清者也	cpib
圣之时者也	cpjb
生之质也	tprb
生子还如孙仲谋	tbgy
十爱词	feyn
石安民	dpna
十八年来堕世间	fwru
势拔五岳掩赤城	rrgf
十八香	fwtj
适百里者	tdjf
适彼乐国	ttql
适彼乐郊	ttqu
侍婢卖珠回	wvfl
师不必贤于弟子	jgnb
士不可以不弘毅	fgsu
时不可止	jgsh
十步杀一人	fhqw
使不上漏	wghi
是不为也	jgyb
誓不相隔卿	rgsq
逝不相好	rgsv
食不厌精	wgdo
时不与我谋	jggy
时不再来	jggg
食不足	wgkh
是豺狼也	jeqb
使臣将王命	wauw
始臣之解牛之时	vapj
是诚不能也	jygb
是诚何心哉	jywf
诗成笑傲凌沧洲	ydti
是重阳	jtbj
是处青山可埋骨	jtgm
世传吕览	awkj
视此而已	phdn
施从良人之所之	ywyp
士大夫之族	fdfy
适当其时	tiaj
失道而后德	rudt
失道非关出襄野	rudj
师道之不复	jupt
失德而后仁	rtdw
适得府君书	ttyn
始得西山宴游记	vtsy
时登大楼山	jwdm
试登绝顶望乡国	ywxl
时滴枝上露	jisf
适冬之望日前后	ttpr
失而不忧	rdgn
视尔不臧	pqgd
十二红	ffxa
士而怀居	fdnn
十二郎	ffyv
十二楼五城	ffsf
十二楼中尽晓妆	ffsu
士贰其行	faat
十二侵	ffwv
十二时	ffjf
十二文	ffyy
十二锡	ffqj
仕而优则学	wdwi
十方法界	fyil
使舫载之	wtfp
是非君子之道	jdvu
是非之涂	jdpi
十分诚挚	fwyr
十分寒冷	fwpu
史凤	kqmc
式负版者	aqtf
使负栋之柱	wqss
事父母几谏	gwxy
试拂铁衣如雪色	yrqq
士甘焚死不公侯	fasw
势高竞奔注	ryui
试共野人言	yajy
石鼓歌	dfsk
是故哂之	jdkp
事姑贻我忧	gvmn
石鼓之歌止于此	dfph
十鼓只载数骆驼	ffkc
十卦	fgff
石贯	dgxf
示官吏	fpgk
使还	wggi
是何人也	jwwb
是何言也	jwyb
使乎使乎	wtwt
石湖仙	diwm
诗画本一律	ygst
室坏不修	pfgw
仕宦于台阁	wpgu
始皇之心	vrpn
十灰	fgdo
实获我心	patn
石季龙	dtdx
石矶西畔问渔船	ddst
诗家清景在新春	ypid
世家三十	apdf
世间出世间	aubu
时见归村人	jmjw
世间何物比轻盈	auwe
时见松枥皆十围	jmsl
世间行乐亦如此	auth
世间已千年	aunr
时见幽人独往来	jmxg
誓将报主静边尘	ruri
誓将挂冠去	rurf
逝将去女	rufv
誓将上雪列圣耻	ruhb
使骄且吝	wcey
世界微尘里	altj
室仅方丈	pwyd
拭尽英雄泪	rnai
时景如飘风	jjvm
市井十洲人	yffw
诗经卫风	yxbm
施酒监	yijt
酾酒临江	siji
尸鸠在桑	nvdc
是菊花开日	jaaj
始觉有迁谪意	vidu
使君从南来	wvwg
识君恨不早	yvnj
事君尽礼	gvnp
使君自有妇	wvtv
试开临水殿	ygjn
试开云梦羔儿酒	ygfi
试看天地翻覆	yrgs
石恪	dgnt
是可忍也	jsvb
诗可以兴	ysni
始可与言诗已矣	vsgc
实可憎	psnu
十口隔风雪	fkbf
使快弹数曲	wnxm
师旷之聪	jjpb
诗老不知梅格在	yfgd
实劳我心	patn
视历复开书	pdtn
十里一走马	fjgc
食莲谁不甘	waya
始怜幽竹山窗下	vnxg
事了拂衣去	gbrf
石麟	dgyn
石廪腾掷堆祝融	dyeg
誓令疏勒出飞泉	rwnr
使六国各爱其人	wulw
石榴花	dsaw
石榴酒	dsis
十六君远行	fuvt
十六诵诗书	fuyn
十六叶	fukf
十六字令	fupw
十六字令三首	fupu
是鲁孔丘与	jqbg
世路无穷	akfp
世路有屈曲	akdm
世乱各东西	atts
世乱同南去	atmf
适莽苍者	taaf
石门千仞断	duto
使民不为盗	wngu
使民不争	wngq
使民敬忠以劝	wnac
使民如承大祭	wnvw
使民心不乱	wnnt
使民心一	wnng
使民以时	wnnj
使民战栗	wnhs
时命大谬也	jwdb
诗名满天下	yqig
十亩之间	fypu
是难能也	jccb
十年曾一别	fruk
十年离乱后	fryr
十年栽种百年规	frff
十年征戍忆辽阳	frtb
士女欢娱万国同	fvcm
侍女金盘脍鲤鱼	wvqq
十拍子	frbb
世披靡矣扶之直	aryf
事其大夫之贤者	gadf
弑其君者	qavf
失其民也	ranb
失其民者	ranf
视其所以	parn
十七为君妇	fayv
失其心也	ranb
是其言也	jayb
适千里者	ttjf
市桥官柳细	yspx
是妾断肠时	juoj
事亲是也	gujb
是禽兽也	jwub
事亲为大	guyd
时清独北还	jiqg
世情恶衰歇	angj
世情已逐浮云散	anna
事去千年犹恨速	gftg
势曲已回萦	rmna
失却烟花主	rfoy
世人不识东方朔	awgu
使人成荒淫	wwdi
失仁而后义	rwdy
是人寰	jwpl
世人见我轻鸿毛	awmt
世人解听不解赏	awqi
世人皆欲杀	awxq
诗人老去莺莺在	ywfd
诗人例作水曹郎	ywwy
时人莫小池中水	jwai
使人听此凋朱颜	wwku
诗人兴会更无前	ywiu
市人行尽野人行	ywtt
时人已知处	jwnt
诗人玉屑	ywgn
适人之适	twpt
是人之所欲也	jwpb
世人自弃我	awtt
十日春寒不出门	fjdu
十日画一水	fjgi
事如春梦了无痕	gvdu
事若不成	gagd
诗三百篇	yddt
十三能织素	fdcg
十三覃	fdsj
十三问	fduk
十三元	fdfq
十三职	fdbk
世上岂无千里马	ahmc
世上未有如公贫	ahfw
世上无难事	ahfg
世上无知音	ahfu
十觞亦不醉	fqys
是社稷之臣也	jptb
史深	kqip
十生九死到官所	ftvr
世事波上舟	agit
士师不能治士	fjgf
世事蹉跎成白首	agku
室始洞然	pviq
世事多变幻	agqx
世事纷纭从君理	agxg
世事浮云何足问	agiu
始适还家门	vtgu
十世可知也	fasb
世事空知学醉歌	agps
世事两茫茫	agga
师师令	jjwy
世事茫茫难自料	agao
湜湜其沚	iiai
是时尚多垒	jjic
事事四五通	gglc
世事随时变	agby
时时为安慰	jjyn
时时误拂弦	jjyx
十十五五依黄芦	ffga
时时引领望天末	jjxg
世事悠悠	agww
是事之变	jgpy
时时只见龙蛇走	jjkf
士庶人曰	fywj
世叔讨论之	ahyp
事孰为大	gyyd
世衰道微	ayut
是谁之过与	jypg
诗思禅心共竹闲	ylpu
十四寒	flpf
十四为君妇	flyv
十四学裁衣	fliy
十四盐	flfh
世俗之人	awpw
十岁裁诗走马成	fmfd
士虽有学	fkdi
实所共鉴	praj
世态炎凉甚	adoa
世态已更千变尽	adnn
誓天不相负	rggq
使天下之人	wggw
十万工农下吉安	fdap
是罔民也	jmnb
事往日迁	gtjt
是谓不道	jygu
是谓宠辱若惊	jypn
是谓道纪	jyux
是为得之	jytp
是谓反其真	jyrf
是谓过矣	jyfc
是谓惚恍	jynn
实为狼狈	pyqq
是谓能养	jycu
是谓弃之	jyyp
是谓天地根	jygs
是谓微明	jytj
是谓无状之状	jyfu
是为袭常	jydi
是谓袭明	jydj
是谓玄德	jyyt
是谓玄牝	jyyt
是谓要妙	jysv
事文类聚	gyob
试问岭南应不好	yumv
诗文有	yyde
使我不能餐兮	wtgw
使我不能息兮	wtgw
食我农夫	wtpf
使我三军泪如雨	wtdf
使我心痗	wtnu
适我愿兮	ttdw
示我周行	ftmt
十五弹箜篌	fgxt
始吾弗信	vgxw
是无父也	jfwb
十五观奇书	fgcn
十五合	fgwg
十五即乘潮	fgvi
世无难事	afcg
十五泣春风	fgim
十五删	fgmm
十五始展眉	fgvn
世无洗耳翁	afiw
十五咸	fgdg
是吾忧也	jgnb
始吾于人也	vggb
是夕	jgqt
室西连于中闺	pslu
侍香金童	wtqu
失向来之烟霞	rtgf
饰小说以干县令	qiyw
石孝友	dfdc
是醒是醉	jsjs
失性于俗者	rngf
侍轩辕	wllf
史延	kqth
石延年	dtrh
十样花	fsaw
十药	fgax
事业不同	gogm
士也罔极	fbms
事业无穷年	gofr
是夜越吟苦	jyfa
食野之蒿	wjpa
食野之芩	wjpa
是亦彼也	jytb
是以不去	jngf
十一队	fgbw
失义而后礼	rydp
是以后世无传焉	jnrg
是以论其世也	jnyb
十一陌	fgbd
是以圣人	jncw
是以圣人犹难之	jncp
是以圣人欲上民	jncn
是以圣人之治	jnci
是刈是濩	jqji
是亦为政	jyyg
是以谓之文也	jnyb
是以无德	jnft
是以陷邻境	jnbf
十一尤	fgdn
是以有德	jndt
十一真	fgfh
是亦走也	jyfb
时有落花至	jdag
十有七年	fdar
史愚	kqjm
室语	pgyg
是与不是	jggj
石鱼湖	dqid
时雨降矣	jfbc
适遇牧马童子	tjtb
士与女	fgvv
始与秦塞通人烟	vgdo
师与商也孰贤	jguj
使于四方	wgly
施于有政	ygdg
是鱼之乐也	jqpb
施于中谷	ygkw
施于中林	ygks
十月初二日	fepj
十月获稻	feat
十月纳禾稼	fext
十月时	fejf
十月蟋蟀	fejj
十月之交	fepu
诗韵合璧	yuwn
时哉时哉	jfjf
时则不至	jmgg
士则以身殉名	fmnq
时展尺书看	jnnr
石召	dgvk
逝者如斯夫	rfvf
十蒸	fgab
事之本也	gpsb
实之宾也	pppb
食旨不甘	wxga
视之不见其形	ppgg
视之不足见	ppgm
士之耽兮	fpbw
事直皇天在	gfrd
是知津矣	jtic
始知李太守	vtsp
是之取尔	jpbq
时之人	jpww
始知人老不如花	vtwa
失之若惊	rpan
师之所处	jprt
师之所存也	jprb
世之所贵道者	aprf
使之闻之	wpup
始知五岳外	vtgq
时至轩中	jglk
始制有名	vrdq
士志于道	ffgu
师挚之始	jrpv
始终存在	vxdd
世中遥望空云山	akem
石州引	dyxh
湿竹暗浮烟	itjo
使子路反见之	wbkp
使子婴为相	wbms
始卒若环	vyag
始作俑者	vwwf
手把芙蓉朝玉京	rray
手持绿玉杖	rrxs
首戴方山巾	ufym
守而勿失	pdqr
受而喜之	edfp
收绩开史牒	nxgt
守节情不移	pant
手卷真珠上玉钩	rufq
寿楼春	dsdw
受母钱帛多	exqq
寿南山	dfmm
瘦怯那禁舞	unvr
守柔曰强	pcjx
收汝泪纵横	niis
寿山曲	dmma
守身为大	ptyd
收拾金瓯一片	nrqt
手提掷还崔大夫	rrrf
受天百禄	egdp
收天下之兵	nggr
守望相助	pyse
受侮不少	ewgi
受降城下月如霜	ebff
受械于陈	esgb
寿星明	djje
寿阳公主嫁时妆	dbwu
首阳之下	ubpg
寿则多辱	dmqd
守之本也	ppsb
手之所触	rprq
手之舞之	rprp
授之以政	rpng
兽之走圹也	upfb
守拙归田园	prjl
书被催成墨未浓	npwi
书边事	nlgk
疏布缠枯骨	ndxm
书不过语	ngfy
孰不可忍也	ygsb
书不能悉意	ngcu
孰不为事	ygyg
孰不为守	ygyp
孰不知礼	ygtp
数尝於	oiyw
数丛沙草群鸥散	owia
孰短孰长	ytyt
疏而不失	ndgr
述而不作	sdgw
述而第七	sdta
舒而脱脱兮	wdew
鼠翻窗网小惊猜	vtpq
数风流人物	omit
数峰青	omge
孰敢不正	yngg
输肝剖胆效英才	leuf
数罟不入洿池	olgi
戍鼓断人行	dfot
曙光初照演兵场	jipf
蜀国曾闻子规鸟	lluq
蜀国多仙山	llqm
孰后倦焉	yrwg
书画家	ngpe
书剑两无成	nwgd
蜀江春水拍江流	lidi
戍客望边色	dpyq
蜀葵花	laaw
输来其间	lgau
数里入云峰	ojtm
疏粝亦足饱我饥	noyq
疏帘淡月	npie
庶刘侥幸	yywf
数米而炊	oodo
树密鸟声幽	spqx
树杪百重泉	ssdr
庶民攻之	ynap
庶民去之	ynfp
树木犹为人爱惜	ssqn
孰能为之大	ycyd
孰能御之	yctp
蜀鸟吴花残照里	lqkj
淑气催黄鸟	irwq
蜀琴欲奏鸳鸯弦	lgwx
蜀清守丹穴	lipp
庶情沿物应	yniy
淑人君子	iwvb
数日前	ojue
树色随山迥	sqbm
蜀僧抱绿绮	lwrx
淑慎其身	inat
数声和月到帘栊	ofts
书生身世今如此	ntth
舒氏	wfqa
鼠屎污羹	vniu
树树立风雪	ssuf
疏疏一树五更寒	nngp
啜菽饮水	kaqi
疏松影落空坛静	nsjg
属他人	nwww
树头树底觅残红	susx
孰为此者	yyhf
孰为夫子	yyfb
孰谓微生高直	yytf
数问夜如何	ouyw
叔兮伯兮	hwww
蜀溪春	lidw
孰先传焉	ytwg
蜀先主庙	ltyy
梳晓鬟也	sjdb
舒窈纠兮	wpxw
树艺五谷	sagw
疏雨滴梧桐	nfis
疏雨过中条	nfft
束于教也	ggfb
孰与君少长	ygvt
叔于田	hgll
舒元舆	wfwf
孰云网恢恢	yfmn
孰云吾道非	yfgd
书郑重	nutg
孰知不向边庭苦	ytga
孰知二谢将能事	ytfg
熟知茅斋绝低小	ytai
孰知其极	ytas
树之微风	sptm
树之以桑	spnc
书中复达否	nktg
蜀主征吴幸三峡	lytm
耍孩儿	dbqt
率由旧章	ymhu
霜薄花更发	faan
霜晨月	fjee
双带子	cgbb
双珰丁丁联尺素	cgsg
双调	ccym
双飞西园草	cnsa
双荷叶	cakf
双红豆	cxgk
双渐	ccil
双桨鸿惊	cuin
霜降水痕收	fbin
双泪落君前	ciau
双鲤迢迢一纸书	cqvn
霜落荆门江树空	faap
双目送飞鸿	chui
双皮溜雨四十围	chil
霜凄万树风入衣	fudy
双桥落彩虹	csaj
双入镜中开	ctqg
双声子	cfbb
霜天晓	fgja
双头莲	cual
霜溪冷	fiuw
双悬日月照乾坤	cejf
双燕儿	caqt
双燕离	cayb
双烟一气凌紫霞	cogf
双韵子	cubb
双照泪痕干	cjif
谁爱风流高格调	yemy
水碧沙明两岸苔	igia
水不深	igip
水沉浓	iiip
谁持白羽静风尘	yrri
谁持彩练当空舞	yrer
水赤刃伤手	ifvr
水澹澹兮生烟	iiio
谁道嵇康懒	yutn
谁得而族灭也	ytdb
谁得似	ytwn
水滴铜龙昼漏长	iiqt
水调	iiym
水调歌	iysk
水调歌头游泳	iysi
水东流	iaiy
水风清	imig
水覆难再收	iscn
谁复商量管弦	ytux
水光浮日出	iiib
水光接天	iirg
水国春寒阴复晴	ildj
水旱不知	ijgt
水寒风似刀	ipmv
谁挥鞭策驱四运	yraf
谁毁谁誉	yvyi
水击三千里	ifdj
谁家见月能闲坐	ypmw
谁见泣离群	ymiv
谁见汀洲上	ymih
谁解乘舟寻范蠡	yqtx
水晶帘	ijpw
水晶帘卷近秋河	ijpi
水晶帘下看梳头	ijpu
水静犹明	igqj
水精之盘行素鳞	iopq
谁怜一片影	yngj
谁怜越女颜如玉	ynfg
水流心不竞	iinu
水路疑霜雪	ikxf
水落鱼梁浅	iaqi
水落鱼龙夜	iaqy
水濛濛	iiia
谁能出不由户	ycby
谁能将旗鼓	ycuf
谁能绝人命	ycxw
谁能役役尘中累	yctl
谁念北楼上	ywuh
睡起杨花满绣床	hfsy
水浅而舟大也	iidb
水清石出鱼可数	iido
水去云回恨不胜	iffe
水泉冷涩弦凝绝	irux
水如环佩月如襟	ivgp
水如一匹练	ivgx
水色南天远	iqff
水深波浪阔	iiiu
水深深	iiip
水声激激风吹衣	ifiy
谁适为容	ytyp
谁识卧龙客	yyap
谁似东坡老	ywaf
水天空阔	igpu
水天清	igig
谁为表予心	yygn
谁谓波澜才一水	yyii
谁为含愁独不见	yywm
谁谓河广	yyiy
水为佩	iywm
谁谓雀无角	yyiq
谁谓鼠无牙	yyva
谁谓宋远	yypf
谁谓荼苦	yyaa
水为沼	iyiv
水为之而寒于水	iypi
水纹珍簟思悠悠	ixgw
谁无父母	yfwx
水仙子	iwbb
水泄不通	iigc
水荇牵风翠带长	iadt
谁言气盖世	yyra
谁与共平生	ygat
水与晴空宜	igjp
水月通禅寂	iecp
水云游	ifiy
谁在秋千	ydtt
水哉水哉	ifif
水枕能令山俯仰	iscw
谁知林栖者	ytsf
谁知我心	yttn
谁知尧与跖	ytak
谁之永号	ypyk
谁知真患难	ytfc
谁知之者	ytpf
谁知竹西路	yttk
水中藻荇交横	ikas
谁主沉浮	yyii
水浊不可饮	iigq
舜功禹顾养	eatu
舜何人也	ewwb
顺流而东行	kidt
顺流而东也	kidb
顺人而不失己	kwdn
舜有天下	edgg
朔吹翻江意未平	uktg
硕大且卷	ddeu
硕大无朋	ddfe
说道风光在水西	yums
朔方健儿好身手	uywr
硕人	ddww
硕人其颀	dwar
硕人之宽	dwpp
说甚龙争虎斗	yadu
说怿女美	ynvu
朔云边月满西山	uflm
说之虽不以道	ypku
思悲翁	ldwc
四边伐鼓雪海涌	llwi
四边静	llge
死别已吞声	gknf
驷不及舌	cget
似不能言者	wgcf
斯不善已	agun
思垂空文以自见	ltpm
似从地底来	wwfg
四代好	lwvb
死当结草	gixa
斯得民矣	atnc
斯得天下矣	atgc
思帝乡	luxt
似洞庭	wiyt
死而不祸	gdgp
思而不见	ldgm
思而不能去也	ldgb
死而不亡者寿	gdgd
死而无悔者	gdff
四犯令	lqwy
四方环镇嵩当中	lygk
四方是维	lyjx
四方之内	lypm
四方之政行焉	lypg
斯干	adfg
四更山吐月	lgme
四顾但湖泓	ldwi
四顾山光接水光	ldmi
思归多苦颜	ljqu
思归何必深	ljwi
思归乐	ljqi
思国之安者	llpf
四海翻腾云水怒	litv
四海困穷	lilp
四海遂为家	liup
四海同寒食	limw
四海为家此路穷	liyp
斯害也已	apbn
四海之内	lipm
四豪	lhyp
四和春	ltdw
四和香	lttj
四换头	lrud
嗣皇继圣登夔皋	krxr
死灰吹不起	gdkf
四季花	ltaw
思佳客	lwpt
私见张良	tmxy
似将海水添宫漏	wuii
四角碍白日	lqdj
四角龙子幡	lqdm
四郊秋叶惊摵摵	lutr
四郊未宁静	lufg
死节从来岂顾勋	gawk
斯近信矣	arwc
四境之内不治	lfpi
思君君不来	lvvg
思君君不知	lvvt
思君如百草	lvva
思君如明烛	lvvo
思君如夜烛	lvvo
思君若汶水	lvai
司空曙	npjl
司空图	nplt
四块玉	lfgy
丝罗袄	xlpu
嘶马出门思故乡	kcbx
司马春衫	ncdp
司马德操	nctr
司马光	nciq
司马牛问君子	ncrb
司马牛问仁	ncrw
司马牛忧曰	ncrj
司马图	nclt
司马扎	ncrn
四面芙蓉开	ldag
四明有狂客	ljdp
四牡	lhtr
四牡骙骙	ltcc
四牡业业	ltoo
四牡翼翼	ltnn
似娘儿	wvqt
斯人不可闻	awgu
斯人独憔悴	awqn
寺人孟子	fwbb
斯人清唱何人和	awit
斯仁至矣	awgc
似僧有发	wwdn
死生亦大矣	gtyc
四时不节	ljga
四时更变化	ljgw
四时好	ljvb
四时行焉	ljtg
丝丝心欲碎	xxnd
似诉平生不得志	wygf
斯速已矣	agnc
嘶酸雏雁失群夜	ksqy
四体不勤	lwga
四体康且直	lwyf
斯天下之民至焉	aggg
驷驖	clcf
似万物之宗	wdtp
斯谓之君子已乎	aypt
斯谓之仁已乎	aypt
斯文未丧	ayff
似闻昨者赤松子	wujb
思我小怨	ltiq
俟我于城隅	wtgb
俟我於城隅	wtyb
四无人声	lfwf
思想与精神	lsgp
斯须改变如苍狗	aenq
斯须九重真龙出	aevb
斯焉取斯	agba
斯亦不足畏也已	aygn
斯已而已矣	andc
死已三千岁矣	gndc
思依依	lwwy
似有人开	wdwg
似与不似	wggw
思欲委符节	lwta
斯远暴慢矣	afjc
四园竹	lltt
四月八日	lewj
四月南风大麦黄	lefa
思越人	lfww
四月时	lejf
四月秀葽	leta
似月云中见	wefm
死则同穴	gmmp
死者为归人	gfyw
四纸	lhxq
四质	lhrf
斯知仁矣	atwc
四字令	lpwy
四座无言星欲稀	lyft
松柏本孤直	sssf
松柏生深山	sstm
松柏一迳趋灵宫	ssgp
送别	udkl
宋不足征也	pgkb
送陈章甫	ubug
送崔九	umvt
宋德广	ptyy
宋迪	psmp
宋鼎	pshn
送杜十四之江南	usff
松风吹解带	smkg
松高白鹤眠	syrh
松寒不改容	spgp
宋济	psiy
松际露微月	sbfe
松间明月长如此	sujh
送将归	uujv
宋璟璟	pggj
送君灞陵亭	uviy
送君不觉有离伤	uvgw
送君走马归京师	uvfj
送客湓浦口	upik
宋李清照	psij
送李愿归盘谷序	usdy
送灵澈	uviy
送孟浩然之广陵	ubib
诵明月之诗	yjey
宋齐丘	pyrg
送秦中诸人引	udkx
送人东游	uwai
松如盖	svug
宋若华	pawx
宋若昭	pajv
送僧归日本	uwjs
送上人	uhww
松梢月	ssee
松声晚窗里	sfjj
诵诗三百	yydd
送述古	usdg
讼斯在	yadh
送送多穷路	uuqk
宋苏轼	pala
宋琬	psgp
送魏万之京	utdy
送我至剡溪	utgi
宋务光	ptiq
松下清斋折露葵	sgia
送行人	utww
送杨氏女	usqv
松叶堪为酒	skfi
宋雍	psyx
送友人入蜀	udwl
宋昱	psju
宋玉无愁亦自愁	pgft
宋媛	psve
松月生夜凉	setu
松月夜窗墟	seyf
松月夜窗虚	seyh
嵩云秦树久离居	mfdn
送征衣	utye
宋之问	ppuk
松洲	swiy
送朱大入秦	urdd
宋子侯	pbwn
送子涉淇	ubii
送梓州李使君	usyv
送纵宇一郎东行	uxpt
宿白鹭洲	prki
素娥惟与月	gvne
宿府	pwyw
素冠	gxpf
苏广文	ayyy
苏瑰	algr
苏涣	aliq
苏检	alsw
苏泂	alim
宿鹭起圆沙	pkfi
俗人昭昭	wwjj
素善留侯张良	guqy
素手把芙蓉	grra
素手抽针冷	grru
素手青条上	grgh
素手玉房前	grgu
肃肃莲花界	vval
肃肃其羽	vvan
肃肃兔罝	vvql
肃肃宵征	vvpt
苏台览古	acjd
苏绾	alxp
宿王昌龄隐居	pgjn
苏味道	akut
苏武	alga
苏武魂销汉使前	agfu
苏武庙	agym
宿巫山下	pamg
苏武传	agwf
宿昔梦见之	pasp
苏溪亭上草漫漫	aiyi
苏小门前长短条	aiut
夙兴夜寐	miyp
夙夜在公	mydw
苏易简	ajtu
素衣朱绣	gyrx
苏寓	alpj
苏郁	alde
宿于逆旅	pguy
苏源明	aije
苏芸	alaf
夙遭闵凶	mguq
苏拯	alrb
诉衷情近	yynr
苏子愀然	abnq
算当年	tirh
虽不得鱼	kgtq
虽不能言	kgcy
岁不我与	mgtg
虽不吾以	kggn
遂成知己	udtn
隋堤三月水溶溶	bfdi
随风生珠玉	bmtg
虽覆一篑	ksgt
隋宫	bdpk
岁寒知松柏	mpts
虽褐宽博	kppf
岁华尽摇落	mwna
遂及我私	uett
随君直到夜郎西	bvfs
虽累百世	klda
遂令东海变桑田	uwal
遂令东山客	uwap
遂命酒	uwis
岁暮归南山	majm
岁暮阴阳催短景	mabj
虽然在城市	kqdy
随人作计终后人	bwww
岁仍大熟	mwdy
岁日	mqjj
随山到水源	bmgi
随山将万转	bmul
虽赏之不窃	kipp
遂事不谏	uggy
随师东	bjai
碎石水磷磷	ddid
虽受然灯记	keqy
虽疏食菜羹	knwu
虽速我讼	kgty
虽速我狱	kgtq
岁岁重阳	mmtb
岁岁春草生	mmdt
岁岁金河复玉关	mmqu
虽天地之大	kgfd
虽万被戮	kdpn
虽无宾主意	kfpu
睢盱侦伺能鞠躬	hhwt
虽一毫而莫取	kgyb
岁亦莫止	myah
岁亦阳止	mybh
虽有槁暴	kdsj
虽有绝顶谁能穷	kdxp
虽有荣观	kdac
虽有智慧	kdtd
虽有周亲	kdmu
虽与府吏要	kgys
虽欲勿用	kwqe
遂与之俱出	ugpb
岁月人间促	meww
虽曰未学	kjfi
虽则如云	kmvf
随着中华民族的	bukr
虽执鞭之士	kraf
虽智大迷	ktdo
绥之斯来	xpag
虽之夷狄	kpgq
孙处玄	btyx
孙定	bipg
孙鲂	biqg
孙革	biaf
笋根稚子无人见	tstm
孙顾	bidb
孙光宪	bipt
孙合	biwg
孙居敬	bnaq
孙谋梁国珍	byig
孙佺	biww
孙锐	biqu
孙万寿	bddt
孙纬	bixf
孙惟信	bnwy
孙偓	biwn
孙吴会	bkwf
孙咸	bidg
孙岘	bimm
孙以出之	bnbp
损者三乐	rfdq
损之又损	rpcr
孙子膑脚	bbee
孙子断足	bbok
锁窗寒	qppf
所得是沾衣	rtjy
所恶勿施尔也	rgqb
琐寒窗	gppw
锁寒窗	qppw
所获颇多	rahq
所见明知	rmjt
所交尽豪雄	rund
索酒	fpis
所居未得邻	rnfw
索句渝州叶正黄	fqia
所守或匪亲	rpau
所谓故国者	rydf
所谓立之斯立	ryuu
所谓前洞也	ryub
锁衔金兽连环冷	qtqu
所向无空阔	rtfu
锁阳台	qbck
所以遣将守关者	rnkf
所宜深慎	rpin
所以隐忍苟活	rnbi
所以终日醉	rnxs
所欲与之聚之	rwgp
踏遍青山人未老	kygf
踏春游	kdiy
踏歌词	ksyn
踏青二三月	kgfe
踏青游	kgiy
他人之贤者	wwpf
他日如何举似人	wjvw
他日再相逢	wjgt
踏莎美人	kauw
他山总不如	wmuv
他生未卜此生休	wtfw
他生缘会更难期	wtxa
塔势如涌出	frvb
他席他乡送客杯	wyws
他乡复行役	wxtt
他乡寒食远堪悲	wxpd
他乡生白发	wxtn
他乡胜故乡	wxex
踏月	khee
踏云行	kftf
踏枝间	ksuj
太白与我语	drgy
泰伯第八	dwtw
台城路	cfkh
台城游	cfiy
泰初有无	dpdf
泰而不骄	ddgc
太和万物	dtdt
太湖水	diii
态浓意远淑且真	diuf
太平令	dgwy
太平时	dgjf
太平世界	dgal
苔色连深竹	aqlt
泰山一掷轻鸿毛	dmgt
泰山之下	dmpg
太上不辱先	dhgt
苔深不能扫	aigr
太尉夫人	dnfw
太尉笑且入	dntt
太阳出	dbbm
太乙近天都	dnrf
太乙真君	dnfv
太宰知我乎	dptt
太真含笑入帘来	dfwg
台州地阔海冥冥	cyfp
探春令	rdwy
探春慢	rdnj
坦荡君子	favb
谭方平	yygu
探芳信	rawy
探芳新	raus
叹凤嗟身否	kmkg
弹剑作歌奏苦声	xwwf
谈空说有夜不眠	ypyh
摊破采桑子	rdeb
谭峭	ysmi
弹琴	xugg
潭清疑水浅	iixi
叹息肠内热	kter
叹息未应闲	ktfu
谈笑凯歌还	ytmg
谈笑无还期	ytfa
潭烟飞溶溶	ioni
谭意哥	yusk
谭用之	yepp
贪于财货	wgmw
谈余天雨花	ywga
唐备	yvtl
唐棣之华	yspw
唐扶	yvrf
唐庚	yvyv
汤恢	innd
汤惠休	igws
唐廪	yvyy
堂前月色愈清好	iuev
堂上启阿母	ihyx
堂上四库书	ihln
汤思退	ilve
堂堂大丈夫	iidf
堂堂乎张也	iitb
堂堂剑气	iiwr
堂堂如春	iivd
搪突鼍獭瞋	rpkh
汤文璐	iygk
唐温如	yivk
唐五代	ygwa
倘秀才	wtft
唐暄	yvjp
唐玄宗	yypf
唐尧臣	yaah
唐怡	yvnc
汤有天下	idgg
汤悦	innu
汤之问棘也是已	ipun
唐宗宋祖	yppp
陶翰	bqfj
桃红复含宿雨	sxtf
桃花飞绿水	sani
桃花尽日随流水	sani
桃花开不开	sagg
桃花历乱李花香	sadt
桃花流水窅然去	saif
桃花乱落如红雨	satf
桃花马上石榴裙	sacp
桃花浅深处	sait
桃花人面各相红	sawx
桃花水	saii
桃花溪	saie
桃花细逐杨花落	saxa
桃花一簇开无主	sagy
桃花源里可耕田	sail
桃花源里人家	saip
桃李春风一杯酒	ssdi
桃李得日开	sstg
桃李罗堂前	sslu
桃李无言又何在	ssfd
桃李阴阴柳絮飞	ssbn
陶令不知何处去	bwgf
陶令篱边色	bwtq
陶然共忘机	bqas
陶然共醉菊花杯	bqas
涛似连山喷雪来	iwlg
慆慆不归	nngj
陶陶兀兀	bbgg
陶雍	bqyx
桃园忆故人	slnw
桃源忆故人	sinw
特为尤甚	tyda
滕白	eurr
滕迈	eudn
滕倪	euwv
滕王高阁临江渚	egyi
滕王阁序	eguy
滕文公上	eywh
滕文公下	eywg
腾骧磊落三万匹	ecda
题村舍	jswf
题大庾岭北驿	jdyc
提刀而立	rvdu
题花光画	jaig
题金陵渡	jqbi
剔开红焰救飞蛾	jgxj
涕落百余行	iadt
题木兰庙	jsuy
啼鸟惊残梦	kqns
替人愁	fwto
题僧壁	jwnk
啼时惊妾梦	kjns
涕泗滂沱	iiii
体无咎言	wfty
体性抱神	wnrp
题扬州禅智寺	jryf
剔银灯	jqos
蹄者所以在兔	kfrq
题竹石牧牛	jtdr
天杯宴重臣	gspa
天边树若荠	glsa
天兵怒气冲霄汉	grvi
天兵照雪下玉关	grju
天不可测	ggsi
天长地久	gtfq
天长地久成埃尘	gtfi
天长地阔岭头分	gtfw
天长路远魂飞苦	gtka
天长水阔厌远涉	gtii
天长与地久	gtgq
田澄	lliw
恬淡为上	niyh
天淡云闲今古同	gifm
天道无知	guft
天得一以清	gtgi
天地本无心	gfsn
天地不仁	gfgw
天地合	gfwg
天地既爱酒	gfvi
天地间第一人品	gfuk
天地皆得一	gfxg
天地皆振动	gfxf
天地尚不能久	gfiq
天地为之久低昂	gfyj
天地相合	gfsw
天地一逆旅	gfgy
天地一沙鸥	gfga
天地一指也	gfgb
天地与我并生	gfgt
天地至广大	gfgd
天地之鉴也	gfpb
天地之友	gfpd
天地中间	gfku
天地终无情	gfxn
天地转	gflf
天地庄生马	gfyc
田娥	llvt
天而生也	gdtb
天翻地覆慨而慷	gtfn
天翻地覆三生劫	gtff
田夫荷锄立	lfau
田夫荷锄至	lfag
天高云淡	gyfi
天工人代	gaww
天宫水西寺	gpif
天工与清新	gagu
天寒翠袖薄	gpna
天寒梦泽深	gpsi
天寒远山净	gpfu
天河挂绿水	giri
天和将至	gtug
天何言哉	gwyf
天荒地变心虽折	gafr
天回北斗挂西楼	glus
田家几日闲	lpmu
田家秋作苦	lpta
田家元日	lpfj
田家占气候	lphw
天街七襄转	gtal
天津桥上无人识	gisy
天连五岭银锄落	glga
天禄永终	gpyx
天路幽险难追攀	gkxs
天马凤凰春树里	gcmj
天马歌	gcsk
天门开阖	gugu
天门一长啸	gugk
天明独去无道路	gjqk
天命靡常	gwyi
天末怀李白	ggnr
天姥连天向天横	gvls
天畔独潸然	glqq
天气不和	grgt
天堑变通途	glyw
天清风雨闻	gimu
天清江月白	giir
天秋月又满	gtei
填然鼓之	fqfp
天人清且安	gwip
天容海色本澄清	gpii
天若不爱酒	gagi
天山雪后海风寒	gmfp
天上白玉京	ghry
天上浮云如白衣	ghiy
天上接行杯	ghrs
天上秋期近	ghtr
天上去西征	ghft
天上人间不相见	ghwm
天上人间一样愁	ghwt
天生德于予	gttc
天生一个仙人洞	gtgi
天势围平野	grlj
天实为之	gpyp
天视自我民视	gptp
天书云篆谁所铭	gnfq
甜水令	tiwy
天台瀑布寺	gcif
天台四万八千丈	gcld
天台晓望	gcjy
天台一万八千丈	gcgd
天堂地狱	gifq
天听自我民听	gktk
天外黑风吹海立	gqlu
天外三峰削不成	gqdd
天王圣明	ggcj
天无二日	gffj
天无私覆	gfts
天无为以之清	gfyi
天下多忌讳	ggqy
天下恶乎定	gggp
天下归仁焉	ggjg
天下国家	gglp
天下和	ggtk
天下横行	ggst
天下既已治也	ggvb
天下将自正	ggug
天下皆叛之	ggxp
天下皆谓我道大	ggxd
天下可运於掌	ggsi
天下乐	ggqi
天下莫能臣	ggaa
天下莫能与之争	ggaq
天下莫强焉	ggag
天下难事	ggcg
天下朋友皆胶漆	ggei
天下伤心处	ggwt
天下神器	ggpk
天下万物生于有	ggdd
天下未之有也	ggfb
天下无道	ggfu
天下希及之	ggqp
天下信之	ggwp
天下已定	ggnp
天下有大戒二	ggdf
天下有道	ggdu
天下有道则见	ggdm
天下有始	ggdv
天下犹未平	ggqg
天下云集响应	ggfy
天下之本在国	ggpl
天下之水	ggpi
天下之言	ggpy
天下之至柔	ggpc
天香留凤尾	gtqn
天香引	gtxh
天香云外飘	gtfs
天旋地转回龙驭	gyfc
天涯孤棹还	gibg
天涯哭此时	gikj
天涯流落思无穷	giip
天涯去不归	gifj
天涯日又斜	gijw
天涯霜雪霁寒霄	giff
天涯涕泪一身遥	giie
天涯同此路	gimk
天涯一望断人肠	gige
天涯占梦数	giho
天意高难问	guyu
天易见	gjmq
天阴雨湿声啾啾	gbfk
田游岩	limd
天欲堕	gwbd
天欲雪	gwfv
天欲雨	gwfg
天欲坠	gwbw
田园作	llwt
田章	lluj
天之苍苍	gpaa
天知否	gtgi
天之高也	gpyb
天之将丧斯文也	gpub
天之历数在尔躬	gpdt
天之未丧斯文也	gpfb
天之小人	gpiw
天质自森森	grts
田中行	lktf
天子不仁	gbgw
添字采桑子	ipeb
天子非常赐颜色	gbdq
天子呼来不上船	gbkt
天子穆穆	gbtt
天尊地卑	gufr
跳波自相溅	kiti
迢递高城百尺楼	vuys
迢递三巴路	vudk
迢递嵩高下	vumg
迢递送斜晖	vuuj
迢迢半紫氛	vvur
迢迢见明星	vvmj
迢迢牵牛星	vvdj
挑兮达兮	rwdw
苕溪渔隐丛话	aiiy
调笑	ymtt
调笑令	ytwy
岧峣太华俯咸京	mmdy
蜩与学鸠笑之曰	jgij
铁马金戈	qcqa
铁衣远戍辛勤久	qyfq
听臣微志	katf
停船暂借问	wtlu
停舫临孤驿	wtjc
庭空客散人归后	yppr
庭燎	ytod
庭燎之光	yopi
听其言而观其行	kayt
听其言而信其行	kayt
听其言也	kayb
听其言也厉	kayd
听其音	kauj
厅前柳	dusq
庭实	ytpu
听蜀僧浚弹琴	klwg
听蜀僧濬弹琴	klwg
亭亭凤凰台	yymc
亭午暗阡陌	ytjb
庭下如积水空明	ygvj
亭下水连空	ygip
庭下梧桐树	ygss
庭虚近水闻	yhru
庭有枇杷树	ydss
庭院深深	ybii
听猿实下三声泪	kqpi
听筝	krtq
听之不闻其声	kpgf
听之而不闻	kpdu
听之却罢松间琴	kpfg
听之无声	kpff
听止于耳	khgb
听钟未眠客	kqfp
汀洲无浪复无烟	iifo
停舟暂借问	wtlu
同悲万古尘	mddi
彤弓	myxn
通古今之变	cdwy
同谷子	mwbb
彤管有炜	mtdo
同行皆狼狈	mtxq
同乎无知	mtft
桐花落	saai
同居长干里	mntj
铜炉华烛烛增辉	qowi
同辇随君侍君侧	mfbw
通其狂惑	caqa
通神明	cpje
同声自相应	mfty
同是长干人	mjtw
同题仙游观	mjwc
通天下一气耳	cggb
同心干	mnfg
同心与我违	mngf
同学少年多不贱	miim
同穴窅冥何所望	mppy
童颜若可驻	uuac
同养公田	muwl
痛饮狂歌空度日	uqqj
桐阴转午	sblt
同于大通	mgdc
同于道者	mguf
同于德者	mgtf
同于失者	mgrf
童稚开荆扉	utgy
童子解吟长恨曲	ubqm
童子六七人	ubuw
同作逐臣君更远	mwef
头白好归来	urvg
投畀豺虎	rleh
头发上指	unhr
投荒万死鬓毛斑	radg
头颅早悔平生贱	uhjm
头上安头	uhpu
头上玳瑁光	uhgi
头上高山	uhym
头上何所有	uhwd
偷声木兰花	wfsa
投诗赠汨罗	ryml
投我以木李	rtns
投我以木桃	rtns
途次望乡	wuyx
徒此挹清芬	thra
徒此揖清芬	thra
图典失其事	lmrg
土豆烧熟了	fgob
徒法不能以自行	tigt
吐故纳新	kdxu
土国城漕	flfi
兔寒蟾冷桂花白	qpjr
兔罝	qkle
徒劳恨费声	tanf
徒令上将挥神笔	twht
徒留无所施	tqfy
图难于其易	lcgj
涂穷反遭俗眼白	iprr
徒善不足以为政	tugg
兔丝	qkxx
秃厮儿	tdqt
徒为造化功	tyta
突兀压神州	pgdy
徒言树桃李	tyss
兔爰	qkef
团扇复迎秋	lytt
团团走	llfh
退而论书策	vdyt
退而省其私	vdit
推贤进士为务	rjft
吞二周而亡诸侯	gfmw
脱布衫	edpu
拖船一何苦	rtga
脱剑膝前横	ewes
脱帽露顶王公前	emfu
脱身独骑	etqc
脱身独去	etqf
萚兮	arwg
托遗响于悲风	rkkm
托于同体	rgmw
瓦缝参差	gxcu
外连衡而斗诸侯	qltw
外其身而身存	qatd
外无旷夫	qfjf
晚泊浔阳望庐山	jiim
万楚	dnss
万川归之	dkjp
晚次鄂州	juky
万代千秋仰圣君	dwtv
万法本闲	disu
万方乐奏有于阗	dyqu
万方有罪	dydl
晚风吹行舟	jmkt
万夫莫开	dfag
弯弓辞汉月	yxte
万古可为则	ddsm
万古千秋对洛城	ddtf
万古清风	ddim
万古青蒙蒙	ddga
万古惟留楚客悲	ddnd
万古永相望	ddyy
万古云霄一羽毛	ddft
万国尽征戍	dlnd
万国衣冠拜冕旒	dlyy
万壑树参天	dhsg
万户捣衣声	dyrf
万户千门入画图	dytl
万户伤心生野烟	dywo
万户萧疏鬼唱歌	dyas
万花纷谢一时稀	daxt
万家灯火暖春风	dpom
晚家南山陲	jpfb
晚见雁行频	jmdh
万井出新烟	dfbo
纨袴不饿死	xpgg
万籁百泉相与秋	dtdt
万籁此俱寂	dthp
晚来风	jgmq
万籁有声	dtdf
芄兰	avuf
万类霜天竞自由	dofm
万里不惜死	djgg
万里长江横渡	djti
万里长征人未还	djtg
万里春	djdw
万里渡河汾	djii
万里奉王事	djdg
万里浮云卷碧山	djim
万里浮云阴且晴	djij
万里归心对月明	djjj
万里寒光生积雪	djpf
万里黄河绕黑山	djam
万里卷潮来	djug
万里可横行	djst
万里来游还望远	djgf
万里念将归	djwj
万里飘零两鬓蓬	djsa
万里桥西一草堂	djsi
万里禽兽皆遮罗	djwl
万里情	djng
万里清风来	djig
万里人南去	djwf
万里尚为邻	djiw
万里少行人	djiw
万里望孤舟	djyt
万里无云月在中	djfk
万里西风瀚海沙	djsi
万里西风夜正长	djst
万里相逢欢复泣	djsi
万里写入胸怀间	djpu
万里雪飘	djfs
万里眼中明	djhj
万里云罗一雁飞	djfn
万马战犹酣	dchs
万木霜天红烂漫	dsfi
万木已清霜	dsnf
万年春	drdw
万年秋	drto
晚年惟好静	jrng
万年枝	drsf
万牛回首丘山重	drlt
万顷波中得自由	dxim
万顷江田一鹭飞	dxin
宛丘	pqrg
宛丘之上兮	prpw
万取千焉	dbtg
万人不可干	dwgf
万人如海一身藏	dwva
万人凿盘石	dwod
婉如清扬	vvir
万山不隔中秋月	dmge
万乘出黄道	dtbu
万乘之国	dtpl
万事不关心	dggn
万事不可料	dggo
万事到头都是梦	dggs
万事皆波澜	dgxi
万事皆如此	dgxh
万事随时更故新	dgbu
万事随转烛	dgbo
万事悉悠悠	dgtw
万寿无疆	ddfx
万树江边杏	dsis
万水千山只等闲	ditu
晚岁迫偷生	jmrt
晚庭摧玉树	jyrs
弯弯月出挂城头	yyeu
万物并作	dtuw
万物不伤	dtgw
万物负阴而抱阳	dtqb
万物将自宾	dtup
万物将自化	dtuw
万物霜天竞自由	dtfm
万物虽多	dtkq
万物无凋枯	dtfs
万物无以生	dtft
万物一马也	dtgb
万物一齐	dtgy
万物一体	dtgw
万物云云	dtff
万物峥嵘	dtmm
万物之本也	dtpb
万物之多	dtpq
万物之镜也	dtpb
万物作而弗始	dtwv
晚霞明	jfje
万绪千条拂落晖	dxtj
晚叶红残楚	jkxs
晚有弟子传芬芳	jdua
晚有儿息	jdqt
晚雨秋阴酒乍醒	jfts
晚云烘月	jfoe
万帐穹庐人醉	dmps
宛转蛾眉能几时	pljj
晚妆初过	jupf
王安礼	gppy
王安中	gpkh
王变乎色	gytq
王表	ggge
王播	ggrt
王粲春来更远游	ghdi
望残烟草低迷	ygoo
王苍	ggaw
望长城内外	ytfq
王昌龄	gjhw
望春回	ydlk
王绰	ggxh
王从叔	gwhi
汪存	igdh
网打尽	mrny
王道荡荡用无为	guay
枉道而事人	sudw
王道亨	guyb
王道之始也	gupb
王德真	gtfh
王涤	ggit
望洞庭湖	yiyi
望断南飞雁	yofd
望断平时翠辇过	yogf
往而不返	tdgr
往而不害	tdgp
忘而复之	ydtp
亡而为有	ydyd
王梵志	gsfn
王风委蔓草	gmta
望夫歌	yfsk
王福娘	gpvy
望夫石	yfdg
王感化	gdwx
王庚	ggyv
王拱辰	grdf
王顾左右而言他	gddw
王光庭	giyt
王硅	ggdf
王翰	ggfj
王何必曰利	gwnt
王赫斯怒	gfav
王槐建	gsvf
王涣	ggiq
往还时屡改	tgjn
望黄鹤楼	yaps
汪极	igse
望蓟门	yauy
王继鹏	gxee
忘迹世所逐	yyae
王季文	gtyy
王继勋	gxkm
王季友	gtdc
王建	ggvf
望江东	yiai
望江梅	yist
望江怨	yiqb
王缙	ggxg
望尽似犹见	ynwm
王敬伯	gawr
王景中	gjkh
王迥	ggmk
王琚	gggn
王居安	gnpv
王巨仁	gawf
王浚楼船下益州	gisy
望君烟水阔	yvou
望君犹伫立	yvqu
王揆	ggrw
往来成古今	tgdw
王澜	ggiu
王丽真	ggfh
王良会	gywf
王良士	gyfg
王镣	ggqd
王令	ggwy
王泠然	giqd
望龙山	ydmm
王鲁	ggqg
王楙	ggsc
望梅	ynst
望梅花	ysaw
望美人兮天一方	yuwy
汪梦斗	isuf
王梦应	gsyi
王勔	ggdm
罔民而可为也	mndb
王命释俘囚	gwtl
王母摘桃海上还	gxrg
忘年忘义	yryy
王雱	gg
望蓬莱	yaag
王彭年	gfrh
王平子	ggbb
王淇	ggia
王起	ggfh
忘其名	yaqk
忘其身以及其亲	yatu
望秦川	ydkt
王请度之	gyyp
王清惠	gigj
王请勿疑	gyqx
王丘	ggrg
亡去不义	yfgy
王仁裕	gwpu
往日崎岖还记否	tjmg
王镕	ggqp
王如知此	gvth
王若岩	gamd
王僧孺	gwbf
王善才	guft
王赏	ggip
王邵	ggvk
王绍宗	gxpf
王沈	ggip
王诜	ggyt
王谌	ggya
王识	ggyk
王适	ggtd
往世不可追也	tagb
往时翰墨颇横流	tjfi
王事靡盬	ggya
王氏女	gqvv
往事千端	tgtu
王室如毁	gpvv
往事越千年	tgfr
往时越千年	tjfr
王枢	ggsa
望书归	ynjv
王苏苏	gaal
王孙归不归	gbjj
王孙善保千金躯	gbut
王孙信	gbwy
王铤	ggqt
往往得神骨	tttm
往往而是	ttdj
王往而征之	gtdp
往往有得	ttdt
王洧	ggid
忘味如闻韶	ykvu
忘我大德	ytdt
忘我实多	ytpq
王武陵	ggbf
王武子	ggbb
王无罪岁	gflm
王希羽	gqnn
望仙楼	ywso
望仙楼上望君王	ywsg
望仙门	ywuy
王仙仙	gwwm
汪相如	isvk
王孝严	gfgo
汪莘	igau
王熊	ggce
王涯	ggid
王偃	ggwa
王喦	ggkk
王彦威	gudg
望洋向若而叹曰	yitj
王沂	ggir
王益柔	gucb
王逸少	gqit
王亿之	gwpp
王邕	ggvk
忘忧碧叶齐	yngy
王右军	gdpl
王幼玉	gxgy
王语暴以好乐	gyjq
王禹偁	gtwe
王于兴师	ggij
王欲行之	gwtp
望远海	yfit
望远行	yftf
王约	ggxq
王越宾	gfpr
望月怀远	yenf
王岳灵	grvo
王月山	gemm
望月有怀	yedn
王云焕	gfoq
王韫秀	gfte
王瓒	gggt
王昭君二首	gjvu
王贞白	ghrr
王正己	ggnn
望之不似人君	ypgv
王之不王	gpgg
王之好乐甚	gpva
王之涣	gpiq
往之女家	tpvp
罔之生也	mptb
王之所大欲	gprw
王之望	gpyn
王智兴	gtiw
望之俨然	ypwq
王重	ggtg
王仲甫	gwge
望终南山	yxfm
王仲舒	gwwf
王胄	ggme
王祝	ggpy
汪晫	igjh
王濯	ggin
王子比干	gbxf
王子皇孙	gbrb
王子乔	gbtd
王子容	gbpw
王自中	gtkh
汪遵	igus
未谙姑食性	fyvn
韦安石	fpdg
为报行人休尽折	yrtr
渭北春天树	iuds
位卑而言高	wrdy
位卑则足羞	wrmu
未必逢矰缴	fntx
韦冰	fnui
微步动云衣	thfy
为不用恩焉	ygeg
为不用力焉	ygeg
维参与昴	xcgj
为草当作兰	yaiu
惟草木之零落兮	nasw
韦蟾	fnjq
未尝饱也	fiqb
未尝不始于是之	figp
未尝见全牛也	fimb
维常之华	xipw
为臣不易	yagj
魏承班	tbgy
渭城朝雨邑轻尘	iffi
韦承庆	fbyd
渭城曲	ifma
为乘阳气行时令	ytbw
唯赤则非邦也与	kfmg
韦处厚	ftdj
渭川田家	iklp
为此春酒	yhdi
为此诗者	yhyf
未达人气	fdwr
为大于其细	ydgx
韦丹	fnmy
唯道集虚	kuwh
未到江南先一笑	fgit
为道日损	yujr
惟道是从	nujw
为道者日损	yufr
未得报恩不能归	ftrj
未得国能	ftlc
未得与项羽相见	ftgm
未抵青袍送玉珂	frgg
为帝王师	yugj
韦鼎	fnhn
未睹斯民康	fhay
为恶无近刑	ygfg
危而不持	qdgr
危而不扶	qdgr
威而不猛	ddgq
为而弗恃	ydxn
委而去之	tdfp
为而三叹其一和	yddt
尾犯	ntqt
未妨惆怅是清狂	fvnq
魏风	tvmq
微风吹兰杜	tmks
微风拂晓	tmrj
维风及雨	xmef
微风惊暮坐	tmnw
为富不仁矣	ypgc
魏夫人	tfww
为父为母	ywyx
为感君王辗转思	ydvl
惟庚寅吾以降	nypb
为公子裳	ywbi
危冠广袖楚宫妆	qpyu
为鬼为蜮	yryj
为国效命	yluw
为国以礼	ylnp
韦洪	fnia
危乎高哉	qtyf
惟恍惟惚	nnnn
韦济	fniy
未几拂荆扉	fmry
为击破沛公军	yfdp
未嫁已倾城	fvnf
韦建	fnvf
韦检	fnsw
未见君子	fmvb
唯见林花落	kmsa
未见其止也	fmab
唯将迟暮供多病	kunu
惟江上之清风	nihm
惟将终夜长开眼	nuxh
惟教宋玉擅才华	nfpw
未解忆长安	fqnp
未解庄生天籁	fqyt
未尽善也	fnub
未就丹砂愧葛洪	fymi
维鸠方之	xvyp
维鸠居之	xvnp
惟酒无量	nifj
惟觉时之枕席	nijy
卫君待子而为政	bvtg
为君零落为君开	yvfg
为君起松声	yvff
为君一击	yvgf
为君吟	yvkw
为君之道	yvpu
微君之躬	tvpt
微君之故	tvpd
韦抗	fnry
未可与立	fsgu
未可与权	fsgs
未可与适道	fsgu
未可知也	fstb
唯恐有闻	kadu
谓孔子曰	ybbj
为礼不敬	ypga
为力不同科	ylgt
惟怜一灯影	nngj
卫灵公第十五	bvwg
渭流涨腻	iiie
魏峦	tvyo
尾闾泄之	nuip
谓门弟子曰	yuuj
唯梦闲人不梦君	ksuv
未免捶楚尘埃间	fqru
微妙玄通	tvyc
为民立极	ynus
委命下吏	twgg
唯命之从	kwpw
为木当作松	ysis
为难能也	yccb
未能事人	fcgw
未能易其节	fcja
为女民兵题照	yvnj
魏朋妻	tegv
帷飘白玉堂	msri
帷屏宠爱空	mnpp
魏朴	tvsh
魏杞	tvsn
谓其大夫曰	yadj
唯其疾之忧	kaun
谓其君不能者	yavf
谓其人曰	yawj
危樯独夜舟	qsqt
为秦宫人	ydpw
卫青不败由天幸	bggf
唯求则非邦也与	kfmg
微躯此外更何求	tthf
维鹊有巢	xadv
为仁不富矣	ywgc
为人臣者	ywaf
为人臣子者	ywaf
为人君者	ywvf
为人谋而不忠乎	ywyt
唯仁者能好人	kwfw
未入于室也	ftgb
葳蕤自生光	aati
未若贫而乐	fawq
为善无近名	yufq
为善最乐	yujq
畏圣人之言	lcwy
微生沾忌刻	ttiy
韦式	fnaa
微诗等瓦砾	tytd
畏湿红莲衣	lixy
唯施是畏	kyjl
惟士为能	nfyc
维石岩岩	xdmm
未始有物	fvdt
维士与女	xfgv
为湿最高花	yija
为寿而已矣	yddc
未收天子河湟地	fngf
韦纾	fnxc
韦述	fnsy
为鼠常留饭	yviq
未数数然也	foob
微霜凄凄簟色寒	tfup
为谁安	yypv
为谁成早秀	yydt
渭水东流去	iiaf
为谁零落为谁开	yyfg
渭水自萦秦塞曲	iitm
韦嗣立	fkuu
唯天为大	kgyd
惟天为大	ngyd
为天下谷	yggw
为天下式	ygga
为天下溪	yggi
为天下笑者	yggf
畏涂巉岩不可攀	lims
畏途巉岩不可攀	lwms
尉佗	nfwp
为王前驱	yguc
卫王氏	bgqa
未闻好学者也	fuvb
为问何时猜得	yuwt
为问门前客	yuup
未闻弑君也	fuqb
为问天戎窦车骑	yugc
惟我独清	ntqi
畏我复却去	lttf
卫我国权	btls
为我开天关	ytgu
为我们的	ytwr
为我书斯文	ytny
帷幄未改神惨伤	mmfw
微我无酒	ttfi
为我一挥手	ytgr
为我沾衣	ytiy
魏武挥鞭	tgra
为吾有身	ygdt
韦夏卿	fdqt
韦骧	fncy
谓行多露	ytqf
危行言孙	qtyb
维熊维罴	xcxl
为修而已矣	ywdc
未休关西卒	fwuy
为学当如流水	yiii
为言地尽天还尽	yyfn
谓言挂席度沧海	yyri
谓言秋霜落	yyta
危言危行	qyqt
谓言无罪过	yyff
渭阳	ilbj
未央前殿月轮高	fmuy
微阳下楚丘	tbgr
维扬忆旧游	xrni
为妖为孽	yvya
唯尧则之	kamp
卫叶	bgkf
维叶莫莫	xkaa
维叶萋萋	xkaa
维以不永怀	xngn
威仪棣棣	dwss
薇亦刚止	aymh
薇亦柔止	aych
惟义所在	nyrd
猥以微贱	qntm
委蛇委蛇	tjtj
薇亦作止	aywh
微吟罢	tklf
为营步步嗟何及	yahe
唯有德者能之	kdtp
未有封侯之赏	fdfi
惟有风入松	ndms
未有涓埃答圣朝	fdif
惟有清风闲	ndiu
未有人知	fdwt
未有天地	fdgf
为有牺牲多壮志	ydtf
唯有相思似春色	kdsq
魏有信陵	tdwb
惟有饮者留其名	ndqq
惟有幽人自来去	ndxf
为有云屏无限娇	ydfv
未有直生枝	fdfs
微雨霭芳原	tffd
谓予不信	ycgw
微雨过	tffp
未语可知心	fysn
惟馀莽莽	nqaa
微雨众卉新	tfwu
惟馀钟磬音	nqqu
韦元旦	ffjg
唯愿当歌对酒时	kdij
韦元甫	ffge
惟愿孩儿愚且鲁	ndbq
魏元忠	tfkh
微云淡河汉	tfii
未云何龙	ffwd
为者败之	yfmp
威振四海	drli
味之不尽	kpgn
谓之才	ypft
为之踌躇满志	ypkf
谓之倒置之民	ypwn
未至二三里	fgfj
为治而已矣	yidc
魏知古	ttdg
谓之何哉	ypwf
谓之后洞	ypri
为之奈何	ypdw
未之能行	fpct
唯止能止众止	khch
谓之仁	ypwf
谓之人乐	ypwq
未之思也	fplb
谓之天子	ypgb
谓之文	ypyy
谓之心	ypny
谓之学	ypip
未之学也	fpib
唯之与阿	kpgb
为之于未有	ypgd
谓之真人	ypfw
韦执中	frkh
维舟绿杨岸	xtxm
微注小窗明	tiij
韦庄	fnyf
畏子不敢	lbgn
微子第十八	tbtw
魏子敬	tbaq
微子去之	tbfp
维子之故	xbpd
未足与议也	fkgb
文丙	yygm
文不在兹乎	ygdt
文采风流今尚存	yemd
问苍茫大地	uaaf
闻蝉但益悲	ujwd
问答乃未已	uten
文道当大行	yuit
问道归凤翔	uuju
闻道黄龙戍	uuad
闻道神仙不可接	uupr
闻道欲来相问讯	uuwy
闻道玉门犹被遮	uugy
文风盛	ymdn
闻风坐相悦	umwn
闻歌始觉有人来	usvg
文鉴	yyjt
文珏	yygg
问君何事轻离别	uvwk
问君何所之	uvwp
问君西游何时还	uvsg
问客何为来	upwg
闻乐不乐	uqgq
问李云	usfc
问其人	uaww
文窃四海声	yplf
问人于他邦	uwgd
文胜质则史	yerk
文史星历	ykjd
汶水滔滔	iiii
闻说梅花早	uysj
闻斯二者	uaff
闻斯行之	uatp
闻斯行诸	uaty
温汤对雪	iicf
问天天不应	uggy
温庭皓	iyrt
文王既没	ygvi
文王之囿	ygpl
温王重茂	igta
温温恭人	iiaw
文翁翻教授	ywtr
问我来何方	utgy
文武并用	ygue
文武衣冠异昔时	ygyj
闻吾子达于至道	ugbu
温宪	ijpt
文献不足故也	yfgb
闻弦歌之声	uxsf
文行忠信	ytkw
问讯吴刚何所有	uykd
文偃	yywa
文益	yyuw
闻义不能徙	uygt
问一得三	ugtd
揾英雄泪	radi
闻余大言皆冷笑	uwdt
问余何意栖碧山	uwwm
问于桀溺	ugqi
问与孔子	ugbb
文章憎命达	yund
文质彬彬	yrss
问舟子	utbb
闻诛一夫纣矣	uygc
翁定	wcpg
翁合	wcwg
翁宏	wcpd
翁绶	wcxe
翁洮	wcii
嗡嗡叫	kkkn
瓮牖绳枢之子	wtxb
翁元龙	wfdx
我爱其礼	teap
我爱夏日长	tedt
我被聪明误一生	tpbt
我辈复登临	tdtj
我辈岂是蓬蒿人	tdmw
我本不弃世	tsga
我本楚狂人	tssw
我本汉家子	tsib
我车既攻	tlva
我持长瓢坐巴丘	trtr
我出我车	tbtl
我粢既洁	tuvi
我从南方来	twfg
我徂东山	ttam
我待贾者也	ttsb
我东曰归	tajj
我独泊兮	tqiw
我独不得出	tqgb
我独昏昏	tqqq
我独闷闷	tquu
我独南行	tqft
我读万卷书	tydn
我独异于人	tqnw
我非生而知之者	tdtf
我歌今与君殊科	tswt
我歌且谣	tsey
我姑酌彼兕觥	tvsq
我行不来	ttgg
我行其野	ttaj
我行殊未已	ttgn
卧后清宵细细长	arit
我家在山西	tpds
我将得邑金	tutq
我今停杯一问之	twwp
我居北海君南海	tnui
我决起而飞	tufn
我觉秋兴逸	titq
卧看满天云不动	arif
我来竟何事	tgug
我来自东	tgta
卧龙跃马终黄土	adkf
我马白	tcrr
我马虺隤	tcgb
我马瘏矣	tcuc
我马玄黄	tcya
我们参照了	twcb
我命绝今日	twxj
我仆痡矣	twuc
我善治马	tuic
我善治木	tuis
我生不有命	ttgw
我生之初	ttpp
我生之后	ttpr
我诗多是别君词	tyqy
我失骄杨君失柳	trcs
我是梦中传彩笔	tjst
我世世为洴澼絖	taax
我是朱陈旧使君	tjrv
我戍未定	tdfp
我书意造本无法	tnui
我思不远	tlgf
我思古人	tldw
我四十不动心	tlfn
我思仙人	tlww
我宿黄山碧溪月	tpae
我虽不敏	tkgt
卧藤萝下	aaag
我腾跃而上	tekh
卧听南宫清漏长	akft
我未见好仁者	tfmf
我未见力不足者	tfmf
我为鱼肉	tyqm
我未之见也	tfpb
卧闻点滴如秋雨	auhf
卧闻海棠花	auia
我无令人	tfww
我无能焉	tfcg
我无是也	tfjb
我无为	tfyl
我武惟扬	tgnr
我舞影凌乱	trjt
我昔钓白龙	taqd
我昔东海上	taah
我心匪鉴	tnaj
我心匪席	tnay
我心悄悄	tnnn
我心伤悲	tnwd
我心素已闲	tngu
我心西悲	tnsd
我心忧伤	tnnw
我心悠悠	tnww
我心则降	tnmb
我心则喜	tnmf
我心则夷	tnmg
我亦教之	tyfp
我亦举家清	tyii
我亦人也	tywb
我以为君	tnyv
我以为兄	tnyk
我以吾仁	tngw
我亦无所求	tyff
我有亲父母	tdux
我有亲父兄	tduk
我有三宝	tddp
我有旨蓄	tdxa
我欲一挥手	twgr
我欲因之梦寥廓	twly
我欲因之梦吴越	twlf
我欲与君相知	twgt
我欲醉眠芳草	twsa
我愿天公怜赤子	tdgb
我在路中央	tdkm
我早生华发	tjtn
我瞻四方	thly
我丈夫也	tdfb
我之不贤与	tpgg
我之大贤与	tpdg
我之怀矣	tpnc
我之谓也	tpyb
我知之濠上也	ttpb
我朱孔阳	trbb
我自岿然不动	ttmf
我醉君复乐	tsvq
我醉欲眠卿且去	tswf
吾爱孟夫子	gebb
吾爱汝至	geig
武安君何在	gpvd
无暴其气	fjar
吾必谓之学矣	gnyc
伍彬	wgss
无不成也	fgdb
吾不得而见之矣	ggtc
吾不复梦见周公	ggtw
吾不忍其觳觫	ggvq
吾不如老农	ggvp
吾不如老圃	ggvl
无不忘也	fgyb
无不为已	fgyn
吾不信也	ggwb
五步一楼	ghgs
无不迎也	fgqb
无不有也	fgdb
吾不欲观之矣	ggwc
吾不与祭	gggw
吾不与也	gggb
吾不知其美也	ggtb
吾不知其名	ggtq
吾不知之矣	ggtc
吴彩鸾	keyo
无才日衰老	ffjf
无恻隐之心	fnbn
吾尝跂而望矣	gikc
吾尝终日不食	gixw
吾尝终日而思矣	gixc
五城十二楼	gffs
无愁可解	ftsq
无处避螳螂	ftnj
无处问	ftuk
吴船录	ktvi
无传其溢言	fway
舞春风	rdmq
无辞让之心	ftyn
吾从而师之	gwdp
毋从俱死也	xwwb
无村眺望赊	fshm
吾党二三子	gifb
吾党有直躬者	gidf
吾党之小子狂简	gipt
吾道一以贯之	gugp
无道则隐	fumb
吾得而食诸	gtdy
无得而逾焉	ftdg
吾得兄事之	gtkp
吴德远	ktfq
武帝祠前云欲散	gupa
屋底达官走避胡	nydd
五帝三皇神圣事	gudg
五帝之所连	gupl
悟定是吾身	npjt
无东无西	fafs
无冬无夏	ftfd
吾读	gkyf
吾独向黄泉	gqtr
无端散出一天愁	fuat
无端听画角	fukq
无对应的	fcyr
物而不物	tdgt
无非积德	fdtt
无风起浪	fmfi
无风云出塞	fmfp
无父何怙	fwwn
无复鸡人报晓筹	ftct
五福降中天	gpbg
无复射蛟江水中	fttk
吴感	kgdg
无感我帨兮	fdtw
吴刚捧出桂花酒	kmri
五歌	ggsk
物各有主	ttdy
五更鼓角声悲壮	ggfu
五更疏欲断	ggno
五更转	gglf
吴巩	kgam
吴宫花草埋幽径	kpat
无功名而治	faqi
无攻人之恶	fawg
五供养	gwud
吴钩霜雪明	kqfj
五谷不分	gwgw
无古无今	fdfw
物固有所可	tlds
物固有所然	tldq
无官一身轻	fpgl
无贵无贱	fkfm
吾何爱一牛	gwer
吾何以观之哉	gwnf
无恒安息	fnpt
无恒产者无恒心	fnun
五侯七贵同杯酒	gwai
呜呼圣皇及圣相	kkcs
呜呼呜呼	kkkk
呜呼吾意其蹉跎	kkgk
五湖烟水独忘机	gios
五花连钱旋作冰	galu
五花马	gacn
五花马千金裘	gacf
吾华肇造	gwyt
无花只有寒	fakp
物换星移几度秋	trjt
吴晃	kgji
武皇开边意未已	grgn
物或恶之	tagp
吴激	kgir
无几无时	fmfj
吴姬压酒唤客尝	kvdi
无极之外	fspq
吴季子	ktbb
吾家读书久不效	gpyu
误佳期	ywad
无家问死生	fput
无家与寄衣	fpgy
吾见其不得已	gman
吾见其进也	gmab
吾见其难为	gmay
吾见其人矣	gmac
勿剪勿伐	quqw
无见小利	fmit
无江海而闲	fiiu
乌江十五兄	qifk
吾将仕矣	guwc
吾将为宾乎	guyt
吾将为名乎	guyt
吾将曳尾于涂中	gujk
吾今且报府	gwey
吾今且赴府	gwey
五茎	ggac
吴兢	kgdq
无君于上	fvgh
吴康	kgyv
无可无不可	fsfs
吾恐季孙之忧	gatn
无苦亦无乐	fayq
无窥其情	fpan
无礼无义	fpfy
五里一徘徊	gjgt
五里一扬鞭	gjga
吾力足以举百钧	glkq
武林春	gsdw
五陵北原上	gbuh
五陵佳气无时无	gbwf
五岭皆炎热	gmxr
五陵年少金市东	gbra
吾令人望其气	gwwr
五岭逶迤腾巨浪	gmti
五岭逶迤腾细浪	gmti
五陵衣马自轻肥	gbye
无漏子	fibb
舞罗衣	rlye
舞马词	rcyn
五马莫留连	gcal
五马如飞龙	gcvd
吴迈远	kdfq
雾满龙冈千嶂暗	fidj
无寐	fqpn
寤寐无为	ppfy
无闷	fqun
无门无毒	fufg
无梦令	fswy
乌蒙磅礴走泥丸	qadv
吴秘	kgtn
无灭无生	fgft
吴敏德	kttf
务民之义	tnpy
无名鬼	fqrq
无名女鬼	fqvr
无名天地之始	fqgv
无名无实	fqfp
物莫之伤	tapw
吾谋适不用	gyte
无母何恃	fxwn
五亩之宅	gypp
无南无北	fffu
无奈朝来寒雨	fdff
无乃尔是过与	feqg
无乃为佞乎	feyt
无奈夜长人不寐	fdyp
无内无外	fmfq
毋内诸侯	xmyw
五年江上损容颜	griu
乌鸟私情	qqtn
吾宁爱与憎	gpen
吴牛喘月时	krkj
五拍	ggrr
误攀织女机	ysxs
武平一	gggg
舞破中原始下来	rdkg
无弃	fqyc
无弃尔辅	fyql
吾妻归宁	ggjp
吾妻来归	gggj
乌栖曲	qsma
吾其为东周乎	gayt
吾其与闻之	gagp
吴潜	kgif
吴黔	kglf
悟清	ngig
无情送潮归	fnuj
无穷无止	fpfh
无求备于一人	fftw
无求生以害仁	fftw
无拳无勇	fufc
无人处	fwth
无人收废帐	fwnm
无人收拾理则那	fwnv
无人送酒来	fwug
无人信高洁	fwwi
无仁义而修	fwyw
无人与我长生术	fwgs
无人争晓渡	fwqi
无人之情	fwpn
无人知所去	fwtf
无日不悠悠	fjgw
五日画一石	gjgd
吾日三省乎吾身	gjdt
吴融	kggk
无容质疑	fprx
无肉令人瘦	fmwu
无如醉中真	fvsf
五色令人目盲	gqwy
巫山神女	ampv
巫山十二峰	amfm
巫山巫峡气萧森	amas
巫山一段云	amgf
巫山一片云	amgf
巫山云雨飞	amfn
无伤吾行	fwgt
无伤吾足	fwgk
吴少微	kitm
侮圣人之言	wcwy
吾生亦有涯	gtyi
无声之中	ffpk
无事不可言	fggy
五世而斩	gadl
五十而知天命	gfdw
无是非之心	fjdn
无使蛟龙得	fwjt
无使尨也吠	fwdk
吴师孟	kjbl
五十年间似反掌	gfri
无食桑葚	fwca
吾失我常与	grtg
无食我麦	fwtg
无食我苗	fwta
无食我黍	fwtt
无食无儿一妇人	fwfw
无视无听	fpfk
无始无终	fvfx
五世希不失矣	gaqc
勿使燕然上	qwah
吴十一	kfgg
五十以学易	gfnj
吾是以忧	gjnn
五十知天命	gftw
五首	ggut
吴叔	kghi
吴淑姬	kiva
吾属今为之虏矣	gnwc
无数铃声遥过碛	foqd
吴淑真	kifh
吾衰竟谁陈	gyub
无思不服	flge
无思远人	flfw
吾斯之未能信	gapw
无俗念	fwwy
乌孙部落家乡远	qbuf
乌孙归去不称王	qbjg
无所不极	frgs
无所不在	frgd
无所祷也	frpb
无所苟而已矣	frac
无所可用	frse
无所求心普空寂	frfp
无所取材	frbs
吾所以有大患者	grnf
无所用心	fren
物态本闲暇	tdsj
伍唐	wgyv
误桃源	ysid
无题二首	fjfu
无题二首之二	fjff
无题二首之一	fjfg
无题四首	fjlu
乌啼隐杨花	qkba
无田甫田	flgl
梧桐儿	ssqt
梧桐树	sssc
梧桐相待老	sssf
梧桐影	ssjy
无万分之一	fdwg
吴王使之将	kgwu
吾王之好鼓乐	ggpq
吾王之好田猎	ggpq
五微	ggtm
五未	ggfi
吾未尝无诲焉	gfig
无为而无不为	fydy
无为而已矣	fydc
无为而治者	fydf
吾未见刚者	gfmf
吾未见其明也	gfmb
勿违今日言	qfwy
五味令人口爽	gkwd
无为名尸	fyqn
无为谋府	fyyy
无为强亲疏	fyxn
无为事任	fygw
误为微物迁	yytt
无为无形	fyfg
无为小人儒	fyiw
勿为醒者传	qysw
吴伟业	kwog
无为在岐路	fydk
物谓之而然	typq
吾未之闻也	gfpb
无为之益	fypu
勿谓知音稀	qytt
无为知主	fyty
无为中有为	fyky
吾闻楚有神龟	gusq
无问其名	fuaq
吾闻其语矣	guac
吴文若	kyad
吾闻上帝心	guhn
吾问无为谓	gufy
吾闻之也	gupb
吾闻诸夫子	guyb
五物	ggtr
无物不可	ftgs
无物不然	ftgq
物物而不物于物	ttdt
物无非彼	tfdt
物无非是	tfdj
物无贵贱	tfkm
吾无间然矣	gfuc
无物结同心	ftxn
吴武陵	kgbf
吾无以为质矣	gfnc
毋吾以也	xgnb
吾无隐乎尔	gfbq
物物者非物	ttft
无物之象	ftpq
无锡景	fqjy
五溪衣服共云山	giym
巫峡啼猿数行泪	amki
无限风光在险峰	fbmm
吾心不忍	gngv
无心可猜	fnsq
吾心甚慰	gnan
无羞恶之心	fugn
无须伤感	fewd
寤言不寐	pygp
五言绝句	gyxq
五言乐府	gyqy
无羊	fqud
舞杨花	rsaw
舞腰	rles
无夜不相思	fygl
梧叶儿	skqt
吴亿	kgwn
吴益	kguw
无意不可入	fugt
无以成江海	fndi
吾意独怜才	guqf
无以故灭命	fndw
吾以观复	gnct
无以立也	fnub
乌衣门第	qyut
无以命之	fnwp
无以人灭天	fnwg
无以汝色骄人哉	fnif
吾亦善之	gyup
无遗身殃	fktg
吾已失恩义	gnry
无以万方	fndy
无以为君子	fnyb
无以为也	fnyb
无衣无褐	fyfp
无以下体	fngw
吾亦信之	gywp
吾已矣夫	gncf
无以异也	fnnb
吾亦欲无加诸人	gyww
无以至今日	fngj
无以知人也	fntb
无以终余年	fnxr
吾以子为异之问	gnbu
五音令人耳聋	guwd
吴隐之	kbpp
吴泳	kgiy
无友不如己者	fdgf
毋友不如己者	xdgf
吾犹不足	gqgk
无由达江浒	fmdi
吾有大树	gdds
吾又何患	gcwk
舞幽壑之潜蛟	rxhj
吾犹人也	gqwb
无有入无间	fdtu
物有死生	tdgt
无有无名	fdfq
吾友张也	gdxb
吾有知乎哉	gdtf
吾与回言终日	gglj
无与士耽	fgfb
无逾我里	fwtj
无逾我墙	fwtf
吾欲云云	gwff
吴圆	kglk
无怨	fqqb
五原春色旧来迟	gddn
吴苑宫闱今冷落	kapa
武元衡	gftq
无远勿届	ffqn
五月不可触	gegq
五岳倒为轻	grwl
五岳祭秩皆三公	grww
五月金石铄	geqq
五月鸣蜩	gekj
五月七日	geaj
五月时	gejf
五月思貂裘	gelf
五月天山雪	gegf
五月五日天晴明	gegj
五月西施采	gese
悟悦心自足	nnnk
五岳寻仙不辞远	grvf
五云垂晖耀紫清	gfti
吴云寒	kfpf
五杂组	gvxe
无灾无难到公卿	fpfq
吾在于天地之间	gdgu
吾至爱汝	ggei
物之残也	tpgb
物之粗也	tpob
物之情也	tpnb
物之生也	tptb
恶之欲其死	gpwg
吾之于人也	gpgb
吾执御矣	grtc
物之质也	tprb
吴中盛文史	kkdk
吴中张翰称达生	kkxt
五洲震荡风雷激	gifi
吴烛	kgoj
无主荷花到处开	fyag
误逐世间乐	yeaq
雾濯清辉苦	fiia
吴子来	kbgo
无自辱焉	ftdg
吾自卫反鲁	gtbq
戏罢曾无理曲时	cluj
西北有高楼	suds
夕避长蛇	qntj
西鄙人	skww
昔别君未婚	akvv
洗兵条支海上波	irti
席不暖君床	ygjy
细草微风岸	xatm
细草香闲小洞幽	xatx
喜朝天	ffgd
昔乘匹马去	ataf
习池风景异	nimn
西川有杜鹃	skdk
喜春来	fdgo
惜春郎	ndyv
惜春令	ndwy
惜此花间月	nhae
夕次盱眙县	quhe
西当太白有鸟道	sidu
希道	qdut
西地锦	sfqr
奚而不丧	edgf
惜芳菲	naad
西方学者	syif
西风愁起绿波间	smtu
西风吹老丹枫树	smks
西风多少恨	smqn
西风烈	smgq
西风漫卷孤城	smif
西风生翠萝	smta
吸风饮露	kmqf
西宫南内多秋草	spfa
西宫夜静百花香	spyt
西挂咸阳树	srds
昔归相识少	ajsi
西还	sggi
羲和羲和	utut
惜红衣	nxye
西湖	sgid
西湖边	silp
西湖春	sidw
西湖路	sikh
西湖天下景	sigj
西湖月	siee
溪花与禅意	iagu
惜黄花	naaw
溪涧岂能留得住	iimw
喜见外弟又言别	fmqk
西江怀古	sind
西江接锦城	sirf
西江上	sihh
西江月井冈山	siem
洗尽古今人不倦	indw
溪居	iend
喜君贻我一枝春	fvmd
喜看稻菽千重浪	frti
细看来	xrgo
细看涛生云灭	xrig
席夔	yauh
夕揽洲之宿莽	qria
西陵下	sbgh
细柳新蒲为谁绿	xsux
细柳营前叶漫新	xsau
溪柳自摇沙水清	isti
西楼望月几回圆	ssyl
西楼子	ssbb
西路蝉声唱	skjk
西陆蝉声唱	sbjk
系马高楼垂柳边	tcyl
西梦令	sswy
西南火星如弹丸	sfov
西南其户	sfay
昔年亲友半凋零	aruf
昔年有狂客	ardp
熙宁三年	apdr
喜怒哀乐	fvyq
惜奴娇	nvvt
犀辟尘埃玉辟寒	nnip
西平乐	sgqi
惜其不成	nagd
奚其为为政	eayg
咥其笑矣	katc
惜秦皇汉武	ndrg
惜琼花	ngaw
奚取于三家之堂	ebgi
昔人已乘白云去	awnf
昔日长城战	ajth
昔日芙蓉花	ajaa
昔日横波目	ajsh
昔日青青今在否	ajgg
昔日太宗拳毛騧	ajdc
昔日戏言身后事	ajcg
昔三后之纯粹兮	adrw
西山白雪三城戍	smrd
西山鸾鹤群	smyv
西上太白峰	shdm
溪上遥闻精舍钟	iheq
席上作	yhwt
希圣如有立	qcvu
昔时飞箭无全目	ajnh
昔时金阶白玉堂	ajqi
西施宁久微	sypt
昔时人已没	ajwi
昔时燕家重郭隗	ajab
西施宜笑复宜颦	syph
西施咏	syky
西施越溪女	syfv
洗手作羹汤	irwi
蟋蟀在堂	jjdi
惜双双	nccc
希叟	qdvh
昔岁逢太平	amtg
昔随刘氏定长安	abyp
西屠石堡取紫袍	sndp
细推物理须行乐	xrtq
喜外弟卢纶见宿	fqup
西望长安不见家	sytp
西望瑶池降王母	sygx
昔闻洞庭水	auii
息我以死	ttng
溪午不闻钟	itgq
习习谷风	nnwm
嬉戏莫相忘	vcay
栖栖一代中	ssgk
西溪子	sibb
西下峨眉峰	sgmm
奚暇治礼义哉	ejif
习相远也	nsfb
嬉笑怒骂	vtvk
西笑吟	stkw
洗心向溪月	inte
西兴浦口	siik
稀星乍有无	tjtf
希言自然	qytq
夕阳度西岭	qbym
夕阳连雨足	qblk
夕阳楼	qbso
夕阳千万峰	qbtm
夕阳依旧垒	qbwc
西忆故人不可见	sndm
徙倚湖山欲暮时	twij
西意曲	suma
奚以知其然也	entb
隰有苌楚	bdas
戏有此赠	cdhm
隰有荷华	bdaw
昔有佳人公孙氏	adwq
席豫	yacb
惜余春	nwdw
细雨春风花落时	xfdj
细雨霏微	xfft
惜与故人违	ngdf
惜余欢	nwcq
细雨梦回鸡塞远	xfsf
细雨濛濛欲湿衣	xfiy
细语人不闻	xywu
细雨湿流光	xfii
细雨湿衣看不见	xfim
细雨无人我独来	xffg
西园翰墨林	slfs
西原贼入道州	sdmy
西岳莲花山	sram
西岳峥嵘何壮哉	srmf
昔在长安醉花柳	adts
昔在九江上	advh
隰则有泮	bmdi
洗盏更酌	iggs
西征问烽火	stuo
昔之得一者	aptf
膝之所倚	eprw
系舟仙宅下	ttwg
犀箸厌饫久未下	ntdg
西子	sgbb
西子蒙不洁	sbai
西子妆	sbuv
西子妆慢	sbun
昔作女儿时	awvj
夏初临	dpjt
下床畏蛇食畏药	gyla
吓倒蓬间雀	kwai
下德不失德	gtgt
遐方怨	nyqb
夏风多暖暖	dmqj
夏歌	dhsk
夏鸿	dhia
夏侯审	dwpj
夏侯孜	dwbt
下江陵	gibf
夏景	dhjy
侠客行	wptf
下窥指高鸟	gprq
匣里金刀血未干	ajqf
峡里谁知有人事	mjyg
夏礼吾能言之	dpgp
下临仍欲坠	gjwb
下流多谤议	giqy
下马入车中	gctk
下马饮君酒	gcqi
夏倪	dhwv
下平声	ggfn
下潜黄泉	giar
夏日南亭怀辛大	djfd
夏日消溶	djii
夏日消融	djig
下上其音	ghau
下士闻道	gfuu
下手迟	grny
下水船	gite
夏水欲满君山青	diwg
下学而上达	gidd
夏莺千啭弄蔷薇	data
下有长流之川	gdtk
下有渌水之波澜	gdii
下有伤心之春草	gdwa
夏雨雪	dffv
夏云峰	dfmt
夏之日	dpjj
下至于兹	gggu
夏州	dhyt
闲爱孤云静爱僧	uebw
衔杯乐圣称世贤	tsqj
羡长江之无穷	utip
咸池	dgib
闲持贝叶书	urmn
险处不须看	btgr
先大母婢也	tdxb
先帝侍女八千人	tuww
先帝天马玉花骢	tugc
闲读道书慵未起	uyuf
仙娥今下嫁	wvwv
鲜肥属时禁	qens
仙风吹下御炉香	wmkt
仙风道骨今谁有	wmud
先拂声弦后角羽	trfn
献赋十年犹未遇	fmfj
县官急索租	epqt
闲过信陵饮	ufwq
献何人	fwww
闲花落地听无声	uaaf
闲即傍边立	uvwu
先进第十一	tftg
先进于礼乐	tfgq
闲居三月	unde
闲看秋水心无事	urtg
闲窥石镜清我心	updn
闲鹭栖常早	uksj
闲门向山路	uutk
先难而后获	tcda
衔泥巢君屋	tivn
衔泥燕	tiau
先期汗漫九垓上	taih
先期零落更愁人	tafw
咸其自取	datb
先遣小姑尝	tkii
仙人抚我顶	wwrs
仙人拊我顶	wwrs
仙人如爱我	wwvt
仙人十五爱吹笙	wwft
仙人有待乘黄鹤	wwdp
仙人掌上雨初晴	wwij
岘山怀古	mmnd
先圣后圣	tcrc
先事后得	tgrt
咸酸杂众好	dsvv
仙台初见五城楼	wcps
仙桃正发花	wsga
先汪	tfig
先王之道斯为美	tgpu
宪问第十四	putl
掀舞一叶白头翁	rrgw
闲暇者之所好也	ujfb
闲闲令	uuwy
贤贤易色	jjjq
献仙音	fwuj
纤纤作细步	xxwh
县小更无丁	eigs
咸言意气高	dyuy
咸阳古道音尘绝	dbdx
咸阳游侠多少年	dbir
闲依农圃邻	uwpw
闲倚一枝藤	uwga
仙游未曾歇	wifj
贤与不肖	jggi
贤愚千载知谁是	jjtj
闲与仙人扫落花	ugwa
纤云四卷天无河	xfli
闲云潭影日悠悠	ufiw
贤哉回也	jflb
贤者而后乐此	jfdh
贤者识其大者	jfyf
贤者在位	jfdw
先知风起月含晕	ttmj
先至洛阳城	tgif
仙之人兮列如麻	wpwy
闲中好	ukvb
献衷心	fyny
先主武侯同閟宫	tygp
先醉	tfsg
闲坐悲君亦自悲	uwdd
闲坐说玄宗	uwyp
相悲各问年	sdtr
相彼鸟矣	stqc
巷伯	awwr
项伯杀人	awqw
项伯许诺	awyy
项伯亦拔剑起舞	awyr
相传称乱石	swtd
乡党第十	xitf
想得读书头已白	styr
象帝之先	qupt
香殿早迎春	tnjd
相对如梦寐	scvp
想对心凄然	scnq
相对亦忘言	scyy
翔而后集	udrw
湘妃雨后来池看	ivfr
湘妃怨	ivqb
相逢不相识	stgy
相逢不用忙归去	stgf
相逢方一笑	styt
相逢红尘内	stxm
相逢每醉还	sttg
相逢秋月满	stti
相逢畏相失	stlr
相逢行	sttf
相逢意气为君饮	stuq
象服是宜	qejp
相公归	swjv
相顾怜无声	sdnf
向滈	tmiy
相恨不如潮有信	sngw
向湖边	tilp
项脊生曰	aitj
相见不得亲	smgu
相见不相知	smgt
相见情已深	smni
相见少	smit
相见语依依	smyw
湘江北去	iiuf
湘江竹上痕无限	iitb
相敬如宾不相睹	savh
相看白刃血纷纷	srrx
向来吟秀句	tgkq
箱帘六七十	tpuf
香炉初上日	topj
香炉瀑布遥相望	toiy
乡路迢迢	xkvv
香罗拭手春事违	tlrf
象弭鱼服	qxqe
香气为谁发	tryn
相亲相近水中鸥	susa
香球	tjgf
相去若何	sfaw
相去四十里	sflj
相去远矣	sffc
乡人皆恶之	xwxp
乡人皆好之	xwxp
向人微露丁香颗	twtj
乡人饮酒	xwqi
相濡以沫	sini
相如作赋得黄金	svwq
香山会	tmwf
相识三十年	sydr
相失万重云	srdf
相守夜欢哗	spyk
相鼠	shvn
乡书不可寄	xngp
相鼠有齿	svdh
相鼠有皮	svdh
相鼠有体	svdw
湘水无情吊岂知	iift
项斯	adad
相思不相见	slgm
相思愁白苹	slta
相思苦	slad
相思泪成行	slit
相思令	slwy
相思明月夜	sljy
相思难见面	slcd
相思始觉海非深	slvi
相思无终极	slfs
相思相见知何日	slsj
相思一夜梅花发	slgn
相思远	slfq
相思在何处	sldt
相思子	slbb
相送还成泣	sugi
相送情无限	sunb
向天盏	tggl
向晚横吹悲	tjsd
向晚猩猩啼	tjqk
项王按剑而跽曰	agrj
襄王安在哉	ygpf
项王军在鸿门下	agpg
项王默然不应	agly
相望始登高	syvy
相望试登高	syyy
项王未有以应	agfy
相望限风烟	sybo
相望相思不相见	sysm
项王则受壁	agmn
相维辟公	sxnw
香雾霏霏月转廊	tffy
巷无居人	afnw
象喜亦喜	qfyf
相携及田家	srep
乡心新岁切	xnua
庠序之教	yypf
襄阳道	ybut
襄阳歌	ybsk
襄阳好风日	ybvj
相邀归渡头	srju
香叶终经宿鸾凤	tkxm
相忆采芙蓉	snea
湘驿女子	icvb
香印成灰	tqdd
乡音难改鬓毛衰	xucy
相迎不道远	sqgf
象忧亦忧	qnyn
相与步于中庭	sghy
项羽季父也	antb
相与烜赫流淳熙	sgoa
相与枕藉乎舟中	sgsk
湘月	isee
相月	shee
相知何用早	stwj
相知无远近	stfr
项庄拔剑起舞	ayrr
向子諲	tbys
向尊前	tuue
小弁	ihca
小不忍则乱大谋	igvy
小冲山	iumm
小重山令	itmw
销愁斗几千	qtut
笑春风	tdmq
孝慈则忠	fumk
小大由之	idmp
笑而不答心自闲	tdgu
小儿时节	iqja
小儿误喜朱颜在	iqyd
萧妃	avvn
晓耕翻露草	jdta
孝公既没	fwvi
孝恭遵妇道	fauu
箫鼓哀吟感鬼神	tfyp
小姑居处本无郎	ivny
小姑如我长	ivvt
小姑始扶床	ivvy
箫鼓喧喧汉将营	tfka
箫管迎龙水庙前	ttqu
霄汉长怀捧日心	fitn
小荷翻	iato
萧回	avlk
宵济越洪波	pifi
萧建	avvf
笑渐不闻声渐悄	tign
晓见寒溪有炊烟	jmpo
萧结	avxf
笑尽一杯酒	tngi
萧静	avge
萧旷	avjy
晓来百念都灰尽	jgdn
小阑干	iufg
笑揽清溪月	trie
笑里轻轻语	tjly
小梁州	iiyt
小楼吹彻玉笙寒	iskp
小楼新月	isue
小梅花	isaw
宵眠抱玉鞍	phra
小旻	ihjy
箫鸣凤下空	tkmp
小年不及大年	irgr
小鸟时来啄食	iqjw
效颦安可希	uhpq
小秦王	idgg
萧悫	avfp
小人比而不周	iwxm
小人反是	iwrj
小人甘以绝	iwax
小人骄而不泰	iwcd
小人穷斯滥矣	iwpc
小人求诸人	iwfw
小人所腓	iwre
小人同而不和	iwmt
小人下达	iwgd
小人则以身殉利	iwmt
小人之德草	iwpa
小人之过也必文	iwpy
小戎	ihad
笑入荷花去	ttaf
笑入胡姬酒肆中	ttdk
萧瑟动寒林	agfs
萧瑟秋风今又是	agtj
晓山青	jmge
小圣乐	icqi
笑时犹带岭梅香	tjqt
萧疏鬓已斑	andg
孝思维则	flxm
效死勿去	ugqf
小松初数尺	ispn
小碎	ihdy
晓随天仗入	jbgt
小桃红	isxa
小桃花	isaw
骁腾有如此	cedh
孝悌也者	fnbf
萧条异代不同时	atnj
小庭花	iyaw
小宛	ihpq
萧微	avtm
校尉羽书飞瀚海	snni
消息盈虚	iteh
萧项	avad
潇湘何事等闲回	iiwl
潇湘曲	iima
潇湘神	iipy
潇湘水北流	iiii
笑向檀郎唾	ttsk
潇湘夜雨	iiyf
潇湘一夜雨	iigf
萧萧发彩凉	aanu
萧萧枫树林	aass
小小寰球	iipg
萧萧马鸣	aack
潇潇雨	iifg
萧萧雨	aafg
萧昕	avjr
小心学忠孝	inif
小学而大遗	iidk
笑掩微妆入梦来	trtg
小言詹詹	iyqq
逍遥不记年	iegr
逍遥池阁凉	ieiu
逍遥九州	ievy
逍遥乐	ieqi
逍遥如何	ievw
萧意	avuj
萧翼	avnl
笑矣乎	tctu
小邑犹藏万家室	ikqp
萧颖士	axfg
萧彧	avak
小园独酌	ilqs
小园赋	ilmg
小园花乱飞	ilan
小苑莺歌歇	iaaj
晓月过残垒	jefc
晓战随金鼓	jhbf
小镇西	iqsg
小知不及大知	itgt
小知间间	ituu
孝之至也	fpgb
萧至忠	agkh
孝子之至	fbpg
斜拔玉钗灯影畔	wrgl
撷芳词	rayn
挟飞仙以遨游	rnwi
谢傅门庭旧末行	ywut
谢福娘	ypvy
谢公离别处	ywyt
谢公宿处今尚在	ywpd
谢公行处苍苔没	ywti
谢公最小偏怜女	ywjv
斜光照墟落	wija
邂逅相遇	qrsj
携妓东山去	rvaf
谢家来贵门	ypgu
谢家事夫婿	ypgv
胁肩谄笑	eyyt
谢绛	ytxt
谢克家	ydpe
携来百侣曾游	rgdi
谢良辅	yylg
谢懋	ytsc
谢邈	ytee
谢明远	yjfq
谢娘别后谁能惜	yvkn
谢秋娘	ytvy
携手佳人	rrww
携手江村	rris
携手日同行	rrjt
携手上河梁	rrhi
携手同归	rrmj
挟太山以超北海	rdmi
谢陶	ytbq
谢燮	ytoy
谢新恩	yuld
斜阳千万树	wbts
斜阳下	wbgh
斜阳下小楼	wbgs
斜阳照墟落	wbja
谢直	ytfh
颉之颃之	fpyp
谐之言曰	ypyj
新安路	upkh
信不足焉	wgkg
心潮逐浪高	niey
心惆怅	nnnt
新愁往恨何穷	uttp
新炊间黄粱	uoui
信道不笃	wugt
心断绝	noxq
心断新丰酒	noui
信而好古	wdvd
信而后谏	wdry
新丰美酒斗十千	udut
新妇车在后	uvlr
新妇初来时	uvpj
新妇起严妆	uvfu
新妇识马声	uvyf
新妇谓府吏	uvyg
新谷既升	uwvt
新鬼烦冤旧鬼哭	urok
新荷弄晚凉	uagu
辛宏	uypd
新嫁娘	uvvy
信近于义	wrgy
新开一夜风	uggm
新柳	ussq
心莫若和	naat
新念别	uwkl
新年作	urwt
心期卧亦赊	naam
心怯空房不忍归	nnpj
心轻万事皆鸿毛	nldt
心清闻妙香	niut
新晴原野旷	ujdj
欣然起行	rqft
新人不如旧	uwgh
新人美如玉	uwug
心如结兮	nvxw
信如君不君	wvvv
心如铁石	nvqd
心若死灰	nagd
新梢才出墙	usff
信誓旦旦	wrjj
新诗改罢自长吟	uynk
心使气曰强	nwrx
心事数茎白发	ngon
心事同漂泊	ngmi
心事一杯中	nggk
新水令	uiwy
信斯言也	wayb
信宿渔人还泛泛	wpii
心随长风去	nbtf
心随湖水共悠悠	nbiw
心随朗日高	nbyy
心随明月到胡天	nbjg
心随雁飞灭	nbdg
新滩莫悟游人意	uiau
心同野鹤与尘远	nmjf
心无所知	nfrt
心相许	nsyt
欣欣此生意	rrhu
心绪逢摇落	nxta
心绪乱已久	nxtq
新雁过妆楼	udfs
辛延年	utrh
信以成之	wndp
辛夷花尽杏花飞	ugan
心亦忧止	nynh
信有人间行路难	wdwc
心有天游	ndgi
新雨带秋岚	ufgm
心与浮云闲	ngiu
心与广川闲	ngyu
新月如佳人	uevw
信则民任焉	wmng
信则人任焉	wmwg
心折此淹留	nrhq
信者效其忠	wfuk
新政县	ugeg
心知白云外	ntrq
心知长别离	ntty
信知生男恶	wttg
心之忧矣	npnc
心止于符	nhgt
新知遭薄俗	utgw
心中悲	nkdj
心中常苦悲	nkid
心中自不平	nktg
新妆曲未终	uumx
新妆宜面下朱楼	uups
行百里者半九十	tdjf
行比一乡	txgx
行不得	tgtj
行不笃敬	tgta
行不履阈	tgnu
行不忍人之政	tgvg
行不言之教	tgyf
行不由径	tgmt
行藏在我	tadt
星躔牛斗北	jkru
星垂平野阔	jtgu
幸此南夷谪	fhfy
性达形迹忘	ndgy
行到安西更向西	tgps
行道迟迟	tunn
行端	tfum
性短非所续	ntdx
幸而得之	fdtp
邢凤	gamc
行逢落花长叹息	ttat
幸复得此妇	fttv
行歌尽落梅	tsns
行宫	tfpk
星宫之君醉琼浆	jppu
形固可使如槁木	glss
性豪业嗜酒	nyoi
星河秋一雁	jitd
杏花风	samq
杏花两株能白红	sagx
兴尽方下山	inym
行尽胡天千万里	tndj
行尽江南数千里	tnij
行尽青溪不见人	tngw
行经华阴	txwb
邢巨	gaan
邢俊臣	gwah
行军司马智且勇	tpnc
行军用兵之道	tpeu
幸可广问讯	fsyy
兴来今日尽君欢	igwc
兴来每独往	igtt
兴来美独往	igut
兴来无远近	igfr
星临万户动	jjdf
性灵出万象	nvbq
行露	tffk
行路难三首	tkcu
行路难三首之一	tkcg
行路难行路难	tkcc
行迈靡靡	tdyy
形莫若就	gaay
行年四岁	trlm
行其义也	tayb
星桥铁锁开	jsqg
邢群	gavt
行人但云点行频	twwh
行人刁斗风沙暗	twnj
行人弓箭各在腰	twxe
行人皆怵惕	twxn
刑人如恐不胜	gwve
行人驻足听	twck
形若槁骸	gasm
邢邵	gavk
兴是清秋发	ijin
醒时同交欢	sjmc
行天下之大道	tggu
幸勿为过	fqyf
行夏之时	tdpj
形象很美	gqtu
性相近也	nsrb
星象衔新宠	jqtp
行香子	ttbb
性行暴如雷	ntjf
行行如也	ttvb
行一不义	tggy
行义以达其道	tynu
兴因庐山发	ilyn
星影摇摇欲坠	jjrb
行有不得者	tdgf
行于大道	tgdu
星月掩映云朣胧	jere
形之不形	gpgg
行止皆无地	thxf
行之以忠	tpnk
熊大经	cdxc
兄弟不知	kugt
兄弟急难	kuqc
兄弟孔怀	kubn
兄弟离散	kuya
兄弟妻子离散	kuga
兄弟阋于墙	kuuf
兄弟遭杀戮	kugn
雄飞雌从绕林间	dnhu
雄关漫道真如铁	duiq
熊节	ceab
熊经鸟申	cxqj
雄立东方	duay
匈奴围酒泉	qvlr
匈奴未灭	qvfg
熊咆龙吟殷岩泉	ckdr
雄心日千里	dnjj
熊曜	cejn
兄曰	kqjh
雄雉	dctd
胸中不正	ekgg
胸中日月常新美	ekju
胸中之竹	ekpt
秀出九芙蓉	tbva
绣床斜凭娇无那	xywv
绣带儿	xgqt
修德不期获报	wtgr
羞而不为也	udgb
绣户	xtyn
修己以安百姓	wnnv
修己以安人	wnnw
修己以敬	wnna
羞将白发对华簪	uurt
羞将短发还吹帽	uutm
休夸此地分天下	wdhg
绣罗衫	xlpu
绣罗衣裳照暮春	xlyd
修睦	whhf
朽木不可雕	ssgm
朽木不折	ssgr
秀木含秀气	tswr
秀色空绝世	tqpa
秀色掩今古	tqrd
修身不言命	wtgw
袖手何妨闲处看	prwr
修守战之具	wphh
绣停针	xwqf
修我戈矛	wtac
修我甲兵	wtlr
修我矛戟	wtcf
修雅	whah
羞颜未尝开	uufg
修之于家	wpgp
修之于身	wpgt
修之于天下	wpgg
修之于乡	wpgx
羞逐长安社中儿	uetq
徐安国	tplg
徐安贞	tphm
序八州而朝同列	ywyg
徐珌	twgn
徐璧	twnk
虚步蹑太清	hhki
徐敞	twim
许大	ytdd
许鼎	ythn
虚而待物者也	hdtb
虚而为盈	hdye
徐干	twfg
徐浩	twit
徐皓	twrt
徐珩	twgt
徐浑	twip
许浑	ytip
徐积	twtk
许坚	ytjc
许将	ytuq
徐介	twwj
须尽丘壑美	enru
徐经孙	txbi
许敬宗	yapf
徐九皋	tvrd
徐君宝妻	tvpg
徐侃	twwk
虚老严陵	hfgb
徐理	twgj
墟里上孤烟	fjho
许玫	ytgt
徐梦龙	tsdx
许孟容	ybpw
徐勉	twqk
许岷	ytmn
徐凝	twux
须晴日	ejjj
许碏	ytda
徐仁友	twdc
旭日临窗	vjjp
须如猬毛磔	evqd
徐商	twum
虚室有余闲	hpdu
许棠	ytip
许庭	ytyt
徐文长传	tytw
徐斡	twfj
虚无恬淡	hfni
徐希仁	tqwf
徐贤妃	tjvn
徐行不必驷马	ttgc
须行即骑访名山	etvm
徐徐更谓之	ttgp
许宣平	ypgu
许学士	yifg
徐彦伯	tuwr
徐彦若	tuad
徐延寿	ttdt
许瑶	ytge
许尧佐	yawd
徐一初	tgpu
徐夤	twqp
须臾发成丝	evnx
须臾鹤发乱如丝	evpx
须臾静扫众峰出	evgb
须臾日射燕脂颊	evjg
许圉师	yljg
徐元杰	tfso
徐月英	team
勖哉沧洲心	jfin
徐至	twgc
徐之才	tpft
徐知仁	ttwf
续之则忧	xpmn
虚中	hakh
徐仲雅	twah
许子冠乎	ybpt
玄宝	yxpg
玄蝉去尽叶黄落	yjfa
轩车昔曾满	llai
宣城还见杜鹃花	pfga
玄德深矣	ytic
旋风四面起	ymlf
宣父犹能畏后生	pwqt
煊赫大梁城	ofdf
旋抹红妆看使君	yrxv
宣情	pgng
轩然大波起	lqdf
宣室求贤访逐臣	ppfa
悬危悉可惊	eqtn
轩楹势可呼	lsrk
玄幽	yxxx
轩辕弥明	llxj
玄之又玄	ypcy
宣宗宫人	pppw
学不成名誓不还	igdg
薛存诚	adyd
学道不倦	iugw
薛道衡	autq
学而优则仕	idww
学而知之者次也	idtb
雪芳草	faaj
雪飞炎海变清凉	fnou
薛逢	awtd
薛光耀	aiiq
雪花大如手	fadr
雪花飞	fanu
雪花照芙蓉	faja
薛据	awrn
谑浪笑敖	yitg
雪里开花	fjga
雪里题诗泪满衣	fjjy
雪里行军情更迫	fjtr
薛令之	awpp
薛蒙	awap
削木为吏	isyg
薛能	awce
血气方刚	trym
薛奇童	aduj
血气未定	trfp
薛琼	awgy
薛戎	awad
学如不及	ivge
薛昚惑	adak
薛式	awaa
雪狮儿	fqqt
学士吟	ifkw
学书初学卫夫人	inpw
薛涛	awid
薛涛诗	aiyf
薛王沉醉寿王醒	agis
学问类	iuod
学问文章	iuyu
血污游魂归不得	tiit
学仙贵功亦贵精	iwko
雪压冬云白絮飞	fdtn
薛曜	awjn
薛瑶	awge
薛业	awog
雪衣雪发青玉嘴	fyfk
薛莹	awap
薛泳	awiy
薛元超	affh
雪月交光	feui
薛昭蕴	ajax
学之不讲	ipgy
薛准	awuw
寻芳不觉醉流霞	vagf
熏风初入弦	tmpx
熏风自南来	tmtg
寻古登阳台	vdwc
循环不可寻	tggv
熏笼玉枕无颜色	ttgq
寻陆鸿渐不遇	vbij
寻梅	vfst
洵美且都	iuef
洵美且仁	iuew
洵美且异	iuen
寻蒙国恩	vall
驯雀今可嗣	ciwk
寻思起	vlfh
巡天遥看一千河	vgei
寻西山隐者不遇	vsmj
恂恂如也	nnvb
浔言江头夜送客	iyip
浔阳地僻无音乐	ibfq
寻瑶草	vgaj
洵有情兮	idnw
旬有五日而后反	qdgr
亚饭干适楚	gqfs
亚父受玉斗	gweu
崖口上新月	mkhe
雅量涵高远	ajif
揠苗者也	rafb
雅琴飞白雪	agnf
鸭头绿	luxv
亚相勤王甘苦辛	gsau
雅音方可悦	auyn
雅志莫相违	afaf
言必有中	yndk
言辩而不及	yude
颜博文	ufyy
言不及义	ygey
言不可不慎也	ygsb
言不辱者	ygdf
言不顺则事不成	ygkd
言不忠信	ygkw
言采其薇	yeaa
颜粲	uthq
燕草如碧丝	aavx
阎朝隐	ufbq
言迟更速皆应手	yngr
燕处超然	atfq
眼穿仍欲归	hpwj
燕春台	adck
焉得谖草	gtya
焉得置之贡玉堂	gtli
言而不足	ydgk
言而非也	yddb
宴尔新婚	pquv
言而有信	yddw
岩扉松径长寂寥	mysp
言告师氏	ytjq
眼高四海空无人	hylw
言告言归	ytyj
颜公变法出新意	uwyu
燕归来	ajgo
燕归梁	ajiv
雁后归	drjv
眼花耳热后	habr
眼花落井水底眠	haah
沿洄安得住	iipw
言既遂矣	yvuc
眼见客愁愁不醒	hmps
眼角眉梢都似恨	hqnn
雁尽书难寄	dnnp
盐角儿	fqqt
眼看人尽醉	hrws
言可复也	ystb
焉可诬也	gsyb
眼枯即见骨	hsvm
阎宽	uqpa
颜奎	utdf
雁来人不来	dgwg
掩泪悲千古	ridd
掩泪空相向	ript
烟敛云收	owfn
颜令宾	uwpr
言秣其马	ytac
燕南壮士吴门豪	afuy
焉能事鬼	gcgr
焉能为有	gcyd
言念君子	ywvb
烟鸟栖初定	oqsp
掩泣空相向	ript
眼前事	hugk
眼前一杯酒	hugi
宴寝凝清香	pput
宴琼林	pgss
嫣然一笑竹篱间	vqgu
颜仁郁	uwde
言入黄花川	ytak
颜如舜华	uvew
颜如舜英	uvea
颜如渥丹	uvim
颜色不变	uqgy
艳色天下重	dqgt
燕山亭	amyp
岩上无心云相逐	mhfe
颜舒	utwf
偃鼠饮河	wvqi
言树之背	yspu
严霜结庭兰	gfxu
燕台四首	aclu
燕台一去客心惊	acgn
宴陶家亭子	pbpb
烟涛微茫信难求	oitf
宴桃源	psid
燕婉之求	avpf
焉往而不三黜	gtdl
严维	goxw
燕尾绣蝥弧	anxx
雁下芦洲白	dgar
烟销日出不见人	oqjw
言笑晏晏	ytjj
燕笑语兮	atyw
烟斜雾横	owfs
阎选	uqtf
颜萱	utap
言旋言归	yyyj
言寻谷口来	yvwg
檐牙高啄	sayk
厌厌良人	ddyw
偃仰啸歌	wwks
演漾在窗户	iidy
宴瑶池	pgib
严抑	gorq
言刈其楚	yqas
言刈其蒌	yqaa
厌浥行露	ditf
雁引愁心去	dxtf
言隐于荣华	ybgw
燕莺语	aayg
言游过矣	yifc
焉有仁人在位	gdww
奄有天下	ddgg
烟雨莽苍苍	ofaa
颜渊第十二	uitf
颜渊季路侍	uitw
颜渊喟然叹曰	uikj
颜渊问仁	uiuw
严恽	gonp
燕昭王求士	ajgf
燕赵之收藏	afpa
言者所以在意	yfru
言者有言	yfdy
严震	gofd
颜真卿	ufqt
言之必可行也	ypnb
焉知二十载	gtff
颜之厚矣	updc
偃之言是也	wpyb
埏埴以为器	ffnk
燕子不归春事晚	abgj
晏子对曰	jbcj
燕子合金瓯	abwa
燕子衔泥两度新	abtu
晏子治东阿	jbib
杨白花	sraw
杨伯岩	swmd
仰不足以事父母	wgkx
杨乘	sntu
杨持	snrf
阳春	bjdw
阳春歌	bdsk
阳春曲	bdma
阳春一曲和皆难	bdgc
杨德麟	styn
仰而视之曰	wdpj
杨玢	sngw
羊公碑字在	uwdd
杨冠卿	spqt
阳关曲	buma
阳关万里道	budu
阳关引	buxh
杨汉公	siwc
阳和不散穷途恨	btgn
杨衡	sntq
杨厚	sndj
杨花更吹满	sagi
杨花绕江啼晓莺	saxa
杨花似雪	sawf
杨花雪落覆白苹	safa
杨绘	snxw
杨徽之	stpp
阳货第十七	bwta
阳货欲见孔子	bwwb
杨谏	snyg
杨景	snjy
杨敬述	sasy
杨敬之	sapp
杨巨源	said
杨均	snfq
杨浚	snic
杨夔	snuh
仰聆金玉章	wbqu
杨柳东风树	ssas
杨柳渡头行客稀	ssit
杨柳散和风	ssam
杨柳阴阴细雨晴	ssbj
杨柳枝芳菲节	sssa
杨鸾	snyo
扬眉结义黄金台	rnxc
仰面贪看鸟	wdwq
杨凝式	suaa
羊牛下括	urgr
羊牛下来	urgg
杨叛儿	suqt
仰攀人屡息	wswt
杨朴	snsh
杨樵云	ssfc
杨容华	spwx
杨汝士	sifg
养生丧死无憾	utfn
杨适	sntd
仰视百鸟飞	wpdn
杨师道	sjut
羊士谔	ufyk
杨氏为我	sqyt
杨收	snnh
杨嗣复	sktj
杨素	sngx
杨损	snrk
阳台路	bckh
阳台梦	bcss
杨太尉	sdnf
仰天大笑出门去	wgdf
仰天而叹	wgdk
仰天而嘘	wgdk
杨廷玉	stgy
仰头相向鸣	wusk
杨系	sntx
养形之人	ugpw
佯羞不出来	wugg
杨续	snxf
杨颜	snut
杨炎正	sogh
漾漾泛菱荇	iiia
扬扬其香	rrat
洋洋洒洒	iiii
扬扬燕新乳	rrae
杨於陵	sybf
杨虞卿	shqt
扬于王庭	rggy
阳月南飞雁	befd
杨泽民	sina
扬之水	rpii
扬州三首	rydu
阳子之宋	bbpp
杳不知其所之也	sgtb
瑶池阿母绮窗开	gibg
瑶池宴	gipj
瑶池燕	giau
姚发	vint
姚合	viwg
肴核既尽	qsvn
姚鹄	vitf
瑶花	geaw
瑶花慢	ganj
遥寄海西头	epiu
遥见仙人彩云里	emwj
要将宇宙看稊米	supo
遥看一处攒云树	ergs
姚揆	virw
遥窥正殿帘开处	epgt
遥怜故园菊	enda
遥怜小儿女	eniv
姚伦	viww
摇落深知宋玉悲	raid
姚勉	viqk
尧让天下于许由	aygm
邀人傅脂粉	rwwo
姚嵘	vima
邀入赤松家	rtfp
腰若流纨素	eaig
尧舜其犹病诸	aeay
要似昆仑崩绝壁	swjn
瑶台聚八仙	gcbw
窈窕丹青户牖空	ppmp
窈窕世无双	ppac
遥望九华峰	eyvm
遥望南天	eyfg
摇尾而求食	rndw
妖为鬼蜮必成灾	vyrp
姚偓	viwn
邀我登云台	rtwc
姚系	vitx
窈兮冥兮	pwpw
腰下有龙泉	egdr
姚向	vitm
遥想公谨当年	eswr
遥相思	esln
遥相望	esyn
要向潇湘直进	stif
腰悬相印作都统	eesx
喓喓草虫	kkaj
夭夭如也	ttvb
杳杳涯欲斑	ssig
遥遥一水间	eegu
遥夜泛清瑟	eyig
遥有此寄	edhp
药院滋苔纹	abix
尧曰第二十	ajtf
姚月华	vewx
遥指红楼是妾家	erxp
遥知朔漠多风雪	etuf
要之死日	spgj
要知松高洁	stsi
尧之为君也	apyb
夭之沃沃	tpii
要自拔其根	strs
夜半真有力	yufl
夜榜响溪石	yskd
也被越来越多的	bpfr
叶采	kfes
也曾因梦送钱财	bulm
叶阊	kfuj
夜长天色总难明	ytgj
夜池	ywib
夜鼎唯煎药	yhka
夜渡湘水	yiii
夜飞乐	ynqi
夜复夜	ytyw
叶公问政	kwug
叶公语孔子曰	kwyj
夜归临皋	yjjr
夜归鹿门山歌	yjys
野航恰受两三人	jtnw
也很特别	bttk
夜后邀陪明月	yrre
野径入桑麻	jtty
叶景山	kjmm
业就扁舟泛五湖	oyyi
夜久侵罗袜	yqwp
夜久丝管绝	yqxx
曳裾王门不称情	jpgn
野哭千家闻战伐	jktw
夜来花	ygaw
夜来微雨洗芳尘	ygti
夜阑风静谷纹平	yumg
夜阑风静欲归时	yumj
夜阑更秉烛	yugo
夜郎万里道	yydu
野老苍颜一笑温	jfai
野老念牧童	jfwu
野老与人争席罢	jfgl
叶李	kfsb
野鹿呦呦走堂下	jykg
野幕蔽琼筵	jaat
耶娘妻子走相送	bvgu
叶清臣	kiah
夜如何其	yvwa
夜如何其夜未央	yvwm
夜如年	yvrh
叶润	kfiu
野色开烟后	jqgr
夜上受降城闻笛	yhet
夜深静卧百虫绝	yigx
夜市千灯照碧云	yytf
野蔬充膳甘长藿	jaya
夜思	ywln
野寺人来少	jfwi
夜宿寒山寺	yppf
野桃含笑竹篱短	jswt
野田黄雀行	jlat
夜听风雨声	ykmf
夜未艾	yfaq
夜未央	yfmd
夜闻马嘶晓无迹	yucy
耶溪采莲女	biev
耶溪泛舟	biit
叶下洞庭初	kgip
夜下征虏亭	ygty
夜乡晨	yxjd
夜行船	ytte
夜夜不得息	yygt
夜夜达五更	yydg
夜夜当秉烛	yyio
叶叶相交通	kksc
烨烨震电	oofj
夜以继日	ynxj
夜已央	ynmd
夜饮	ywqn
夜吟应讶玉绳低	ykyw
也应攀折他人手	bysr
野营万里无城郭	jady
野有蔓草	jdaa
野有死麕	jdgy
夜雨剪春韭	yfud
夜雨翦春韭	yfud
野语有之曰	jydj
叶元良	kfyv
夜月愁空山	yetm
野月满庭隅	jeib
野云万里无城郭	jfdy
野哉由也	jfmb
野战格斗死	jhsg
野竹攒石生	jtrt
叶祖义	kpyq
夜坐吟	ywkw
以敖以游	ngni
以八千岁为春	nwtd
一百四十年	gdlr
以百姓为刍狗	ndvq
以百姓心为心	ndvn
一百字	gdpb
一般消受	gtie
一半子	gubb
以邦观邦	ndcd
已报生擒吐谷浑	nrti
一杯春露冷如冰	gsdu
一杯相属君当歌	gsss
一杯一杯复一杯	gsgs
衣弊履穿	yunp
一别二十年	gkfr
一别心知两地秋	gknt
一钵千家饭	gqtq
一波三折之笔	gidt
以补不足	npgk
亦不减	ygud
以不教民战	ngfh
意不尽	ugny
亦不可行也	ygsb
亦不能至也	ygcb
亦不女从	ygvw
以不忍人之心	ngvn
亦不入于室	ygtp
亦不甚惜	ygan
亦不失言	ygry
以不同形相禅	ngmp
一不孝也	ggfb
忆长安	ntpv
一唱都护歌	gkfs
一唱雄鸡天下白	gkdr
一重山两重山	gtmm
伊川令	wkwy
忆吹箫	nktv
以慈卫之	nubp
以此下心意	nhgu
一从大地起风雷	gwdf
依丛适自憩	wwtt
一寸金	gfqq
一寸同心缕	gfmx
以待大王来	ntdg
一代风流尽	gwmn
一代天骄	gwgc
已带斜阳又带蝉	ngwj
一旦不能有	gjgd
一旦红颜为君尽	gjxn
以当南日	nifj
以道观之	nucp
以道莅天下	nuag
以道事君	nugv
以道佐人主者	nuwf
以德报德	ntrt
以德报怨	ntrq
以德分人谓之圣	ntwc
以德服人者	ntef
忆得去年春风至	ntfg
以德行仁者王	nttg
忆帝京	nuyi
夷狄之有君	gqpv
一点春	ghdw
一点分明值万金	ghwq
一点浩然气	ghir
倚迭如山	wrvm
一董	ggat
忆东山二首	namu
一斗合自然	guwq
已断燕鸿初起势	noar
猗顿之富	qgpp
一朵芙蓉	gmaa
一朵红苏旋欲融	gmxg
忆多娇	nqvt
亦多可悲	yqsd
以多问于寡	nqup
以尔车来	nqlg
一二三四五	gfdg
宜尔室家	pqpp
已而遂晴	nduj
已而为知者	ndyf
已而已而	ndnd
宜尔子孙	pqbb
伊璠	wvgt
亦泛其流	yiai
意方远	uyfq
宜芬公主	pawy
仪封人请见	wfwm
一夫当关	gfiu
役夫敢申恨	tfnn
以服事殷	negr
弋凫与雁	aqgd
以告者过也	ntfb
倚歌而和之	wsdp
一个朴素	gwsg
夷歌数处起渔樵	gsos
亦各言其志也	ytyb
一更山吐月	ggme
一宫之间	gppu
一钩残月向西流	gqgi
忆故人	ndww
已惯天涯莫浪愁	nngt
已过三寒食	nfdw
一行白鹭上青天	gtrg
衣笐妆台蛛结网	ytum
一鹤东飞过沧海	gpai
以和为量	ntyj
一痕沙	guii
遗恨失吞吴	knrk
异乎三子者之撰	ntdr
依乎天理	wtgg
异乎吾所闻	ntgu
一斛珠	gqgr
已化而生	nwdt
以火来照所见稀	nogt
亦既觏止	yvfh
亦既见止	yvmh
一肌一容	gegp
以家观家	npcp
移家虽带郭	tpky
一家有六口	gpdk
一剑曾当百万师	gwuj
一翦梅	gust
已见松柏摧为薪	nmsa
一箭正坠双飞翼	gtgn
意匠惨淡经营中	uank
一江春水	gidi
一江风	gimq
以降甘露	nbaf
宜将剩勇追穷寇	putp
宜将胜勇追穷寇	puep
忆江月	niee
一叫千回首	gktu
一叫一回肠一断	gkgo
猗嗟	qtku
一截还东国	gfgl
以介眉寿	nwnd
一截遗欧	gfka
一截赠美	gfmu
以就有道	nydu
逸居而无教	qndf
一举累十觞	gilq
一句中	gqkh
已觉山川是两乡	nimx
贻厥孙谋	mdby
忆君泪落东流水	nvii
忆君迢迢隔青天	nvvg
忆君王	nvgg
伊可怀也	wsnb
亦可以弗畔矣夫	ysnf
亦可以为成人矣	ysnc
亦可宗也	yspb
亦孔之固	ybpl
一口吸尽西江水	gkki
一雷惊蛰始	gfnv
以礼存心	npdn
以力服人者	nlef
以利为本	ntys
倚立自移时	wutj
以临其民	njan
一龙一蛇	gdgj
倚楼高望极	wsys
依楼似月悬	wswe
一路经行处	gkxt
一纶茧缕一轻钩	gxaq
一络索	gxfp
一落索	gafp
忆萝月	naee
以媚一世	nvga
医门多疾	auqu
遗民几度垂垂老	knmf
异名同实	nqmp
意难忘	ucyn
以能问于不能	ncuc
一年春	grdw
一捻红	grxa
一年明月今宵多	grjq
一年能几团圆月	grce
一年生意属流尘	grti
一年衔别怨	grtq
一年一度秋风劲	grgc
一年一年老去	grgf
一鸟花间鸣	gqak
一怒而诸侯惧	gvdn
一篇读罢头飞雪	gtyf
一片光明	gtij
一片神行	gtpt
一片汪洋都不见	gtim
一片西飞一片东	gtsa
以其不争	nagq
以其不自生	nagt
以其存心也	nadb
夷齐饿死终无成	gyqd
宜其家人	papw
宜其家室	papp
意气骄奢剧季伦	urcw
一七令	gawy
意气勤勤恳恳	urav
以其求思之深	nafi
以其善下之	naup
宜其室家	papp
意气素霓生	urgt
移其粟于河内	tasm
以其心得其常心	nann
以其兄之子妻之	nakp
以奇用兵	nder
意气由来排灌夫	urmf
以其知得其心	natn
以其智多	natq
以其子妻之	nabp
依前春恨锁重楼	wuds
一千顷	gtxd
一桥飞架南北	gsnu
忆秦娥娄山关	ndvu
一清一浊	gigi
以求长生	nftt
一丘尝欲卧	gria
一曲清歌	gmis
一去一万里	gfgj
一去紫台连朔漠	gfhi
一群娇鸟共啼花	gvva
义然后取	yqrb
怡然敬父执	nqar
衣染异方尘	yini
揖让而升	rydt
揖让月在手	ryer
宜人独桂林	pwqs
已忍伶俜十年事	nvwg
忆人人	nwww
一人之心	gwpn
一日克己复礼	gjdp
一日如三秋	gjvt
一日心期千劫在	gjnd
一日须倾三百杯	gjes
一日之内	gjpm
翼若垂天之云	natf
亦若此矣	yahc
亦若是则已矣	yajc
以若所为	nary
以弱天下之民	nxgn
抑若扬兮	rarw
以色事他人	nqgw
一山飞峙大江边	gmnl
衣上灞陵雨	yhif
衣裳楚楚	yiss
一晌偎人颤	gjwy
衣裳已施行看尽	yinn
一上玉关道	ghgu
一身能擘两雕弧	gtcx
一身无所求	gtff
一身转战三千里	gtlj
一生肝胆向人尽	gten
一生好入名山游	gtvi
一声何满子	gfwb
一生何所求	gtwf
一声鸡唱	gfck
一生几许伤心事	gtmg
忆生来	ntgo
遗声落西秦	kfad
一声羌笛	gfut
一声已动物皆静	gfng
益生曰祥	utjp
一生长对水晶盘	gttt
忆事	nngk
易时不易性	jjgn
疑是故人来	xjdg
义士还乡尽锦衣	yfgy
一时回首月中看	gjlr
疑是林花昨夜开	xjsg
一时起	gjfh
疑是山阴雪后来	xjmg
以诗言志	nyyf
以手抚膺坐长叹	nrrk
以手阖门	nruu
以守则固	npml
一树碧无情	gsgn
倚树沉眠日已斜	wsiw
一树寒梅白玉条	gspt
一树梨花落晚风	gstm
以舒其愤	nwan
驿树西连汉畤平	cssg
以水救水	nifi
以顺天下	nkgg
易思	jqln
已似长沙傅	nwtw
一丝风	gxmq
以俟君子	nwvb
一送	ggud
以俗观之	nwcp
已诉征求贫到骨	nytm
一岁四行役	gmlt
忆岁月	nmee
亦遂增胜	yufe
一索功高缚楚王	gfag
揖所与立	rrgu
一弹一十有八拍	gxgr
一弹再三叹	gxgk
以天下观天下	nggg
以天下之所顺	nggk
倚天照海花无数	wgjo
一汀烟雨杏花寒	giop
已外天下矣	nqgc
一万年太久	gdrq
以万物为刍狗	ndtq
以望复关	nytu
一望弥千里	gyxj
义往难复留	ytcq
一往情深深几许	gtny
抑王兴甲兵	rgir
以危父母	nqwx
以为桂林	nyss
一苇杭之	gasp
以为莫己若者	nyaf
一为迁客去长沙	gyti
一为取龙城	gybf
伊威在室	wddp
抑为之不厌	rypd
已闻清比圣	nuic
以我独沉久	ntqq
以我贿迁	ntmt
移我琉璃榻	ttgs
贻我彤管	mtmt
以我为楷模	ntys
佚我以老	wtnf
以我应他人	ntyw
以我御穷	nttp
以五百岁为春	ngdd
以吾从大夫之后	ngwr
以物观之	ntcp
以无厚入有间	nfdu
一舞剑器动四方	grwy
一舞剑气动四方	grwy
揖巫马期而进之	racp
以五十步笑百步	ngfh
以无事取天下	nfgg
以物为量	ntyj
以吾一日长乎尔	nggq
疑误有新知	xydt
伊昔红颜美少年	waxr
忆昔开元全盛日	nagj
羿昔落九乌	naaq
忆昔霓旌下南苑	nafa
一洗万古凡马空	gidp
一夕小敷山下梦	gqis
忆昔巡幸新丰宫	navp
依稀掩映	wtrj
一西一东	gsga
亦奚以为	yeny
以下见	ngmq
一先	ggtf
一闲对百忙	gucn
一弦清一心	gxin
一弦一柱思华年	gxgr
忆仙姿	nwuq
以乡观乡	nxcx
一向花前看白发	gtan
忆向天阶问紫芝	ntga
一乡之善士	gxpf
一笑倾城欢	gtwc
一笑相倾国便亡	gtsy
以小易大	nijd
以写我忧	nptn
宜兄宜弟	pkpu
一宿行人自可愁	gptt
衣绣夜行	yxyt
噫吁戏	kkca
噫吁戏危乎高哉	kkcf
一虚一满	ghgi
一薛居州	gany
一言而可以兴邦	gydd
一言而丧邦	gydd
遗言冀可冥	kyup
一言为重百金轻	gyyl
一言以蔽之	gynp
一言以为不知	gynt
宜言饮酒	pyqi
一样悲欢逐逝波	gsdi
宜阳城下草萋萋	pbfa
一样花	gsaw
一扬眉	grnh
以养民人	nunw
以羊易之	nujp
忆瑶姬	ngva
一夜飞度镜湖月	gyne
一夜飞渡镜湖月	gyne
一夜好风吹	gyvk
一叶落	gkai
一夜梦中香	gyst
一叶随风忽报秋	gkbt
一夜絮征袍	gyvp
一叶叶	gkkf
一夜一心死	gygg
一叶舟轻	gktl
以意逆志	nuuf
曀曀其阴	jjab
怡怡如也	nnvb
一一生绿苔	ggta
抑亦先觉者	rytf
依依向物华	wwtw
依依墟里烟	wwfo
亦已焉哉	yngf
意疑倚巴丘	uxwr
已矣已矣尚何道	ncnu
亦以御冬	yntt
已矣哉	ncfa
以阴以雨	nbnf
意映卿卿如晤	ujqj
以应无穷	nyfp
已映洲前芦荻花	njia
以永今夕	nywq
疑有碧桃千树花	xdga
以友辅仁	ndlw
邑有流亡愧俸钱	kdiq
贻友人	mdww
亦有仁义而已矣	ydwc
意有所随	udrb
以游无极之野	nifj
以游无穷者	niff
亦有兄弟	ydku
以有涯随无涯	ndii
忆余杭	nwsy
以御今之有	ntwd
意欲凌风翔	uwuu
以愚黔首	njlu
抑与之与	rgpg
一月不梳头	gegu
一月三捷	gedr
依约是湘灵	wxjv
以约失之者鲜矣	nxrc
一月又一月	gece
以阅众甫	nuwg
一则以惧	gmnn
一则以喜	gmnf
一摘使瓜好	grwv
倚杖柴门外	wshq
倚杖候荆扉	wswy
一棹春风一叶舟	gsdt
一朝辞此地	gftf
一朝得成功	gfta
一朝卧病无相识	gfay
亿兆一心	wign
一朝之忿	gfpw
弋者何所慕	afwa
益者三乐	ufdq
倚枕钗横鬓乱	wsqt
一枕初寒梦不成	gspd
忆真妃	nfvn
一枕黄梁再现	gsag
一枕黄粱再现	gsag
以正治国	ngil
以直报怨	nfrq
一枝春	gsdw
义之端也	ypub
一枝红艳露凝香	gsxt
一枝花	gsaw
以知其子	ntab
以致天下之士	nggf
以直养而无害	nfup
以至于无为	nggy
以指喻指之非指	nrkr
已知之矣	ntpc
易重	jqtg
一种可怜生	gtst
伊州令	wywy
一字不救饥	gpgq
一自胡尘入汉关	gtdu
亦自是一家	ytjp
亦足以发	yknn
忆醉	nnsg
一醉累月轻王侯	gslw
一尊还酹江月	guge
以作时世贤	nwjj
以佐五谷	nwgw
银鞍白马度春风	qarm
银鞍照白马	qajc
因步其韵奉和	lhat
因不失其亲	lgru
饮茶粤海未能忘	qaty
隐处唯孤云	btkf
殷琮	rvgp
因而和焉	ldtg
因非因是	ldlj
因风想玉珂	lmsg
吟风韵更长	kmut
引竿自刺船	xttt
饮高秋之坠露	qytf
饮酣视八极	qsps
银汉无声转玉盘	qift
银河吹笙	qikt
银河倒挂三石梁	qiwi
银河亲挽	qiur
因河为池	liyi
尹焕	vtoq
隐患险于明火	bkbo
因击沛公于坐	lfiw
引驾行	xltf
殷鉴不远	rjgf
阴精此沦惑	boha
隐居放言	bnyy
隐居山	bnmm
隐居以求其志	bnnf
饮君酒	qvis
因利乘便	lttw
殷礼吾能言之	rpgp
饮露身何洁	qfti
隐峦	bqyo
饮马渡秋水	qcii
饮马歌	qcsk
引蔓故不长	xadt
尹懋	vtsc
吟弄风月	kgme
吟弄天上春	kggd
尹璞	vtgo
因其固然	lalq
殷其雷	rafl
饮其流者怀其源	qaii
殷七七	raag
吟乔	kwtd
殷勤说	rayu
殷勤移植地	ratf
殷勤昨夜三更雨	rajf
阴晴众壑殊	bjwg
因求假暂归	lfwj
因人作远游	lwwi
饮如长鲸吸百川	qvtk
隐若白虹起	barf
阴山道	bmut
尹式	vtaa
因是因非	ljld
吟诗作赋北窗里	kywj
因望月有感	lyed
因为长句	lytq
殷文圭	ryff
因无恒心	lfnn
蚓无爪牙之利	jfrt
因休暇	lwjn
阴阳调和	bbyt
殷遥	rver
殷尧藩	raai
殷益	rvuw
殷寅	rvpg
隐隐飞桥隔野烟	bbno
隐隐何甸甸	bbwq
阴阴夏木啭黄鹂	bbdg
殷因与夏礼	rlgp
因招樊哙出	lrsb
隐者自怡悦	bftn
银筝夜久殷勤弄	qtyg
因之传远情	lpwn
因之以饥馑	lpnq
银烛吐青烟	qoko
应傍战场开	ywhg
应玚	yign
应长天	ytgd
迎春来	qdgo
应而不藏	ydga
英风豪气今何在	amyd
应共冤魂语	yapy
莺呼起	akfh
樱花永巷垂杨岸	saym
鹰击长空	yftp
应见陇头梅	ymbs
应将性命逐轻车	yunl
应尽便须尽	ynwn
婴金铁受辱	mqqd
应景乐	yjqi
盈科而后进	etdf
应怜半死白头翁	ynuw
应怜脂粉气	yner
赢粮而景从	yodw
英灵尽来归	avnj
影落明湖青黛光	jaji
映门淮水绿	juix
英气勃勃	arff
嘤其鸣矣	kakc
莹若烧玉英	aaoa
映山红	jmxa
莺声绕红楼	afxs
应是钓秋水	yjqi
樱桃花下	ssag
樱桃落尽春归去	ssaf
莺啼如有泪	akvi
莺啼山客犹眠	akmh
莺啼送客闻	akuu
莺啼燕语报新年	akar
颖亭留别	xyqk
应驮白练到安西	ycrs
应为别离多	yykq
鹦鹉杯	mgsg
鹦鹉来过吴江水	mggi
鹦鹉鸟	mgqy
鹦鹉前头不敢言	mguy
鹦鹉曲	mgma
鹦鹉洲	mgiy
影响所及	jkre
迎新春	qudw
英雄割据虽已矣	adpc
英雄五霸闹春秋	adgt
英雄业绩	adox
英雄之言	adpy
应须记	yeyn
盈虚者如彼	ehft
荧荧贝叶宫	aamp
营营何所求	aawf
应有未招魂	ydff
影湛波平	jiig
迎之不见其首	qpgu
颖州	xtyt
营州少年厌原野	ayij
莺啭皇州春色阑	akru
英姿飒爽犹酣战	auuh
勇而无礼则乱	cdft
鄘风	yvmq
咏风兰	kmuf
勇夫安识义	cfpy
永和三日荡轻舟	ytdt
咏槐	kysr
永怀愁不寐	yntp
永怀当此节	ynia
拥彗折节无嫌猜	rdrq
拥炉开酒缸	rogr
永念难消释	ywct
永日方戚戚	yjyd
用舍由时	ewmj
勇士不忘丧其元	cfgf
永矢弗谖	ytxy
雍虽不敏	ykgt
咏闲	kyus
永巷长年怨绮罗	yatl
永相随	ysbd
用心一也	engb
用心躁也	enkb
永言配命	yysw
永言孝思	yyfl
用药如用兵	eavr
雍也第六	ybtu
永夜角声悲自语	yyqy
雍也可使南面	ybsd
永夜月同孤	yyeb
咏意	kyuj
永以为好也	ynyb
拥雍州之地	ryyf
雍裕之	yppp
踊跃用兵	kker
勇者不必有仁	cfgw
勇者竭其力	cful
用志不分	efgw
用之不竭	epgu
用之不足既	epgv
用之如泥沙	epvi
用之所趋异也	eprb
雍之言然	ypyq
泳之游之	ipip
用之则行	epmt
拥肿之与居	repn
雍州之地	yypf
咏拙	kyrb
又被河声搅碎	cpid
有碑仆道	ddwu
有悲往事	ddtg
有本者如是	dsfj
油壁车	inlg
有鄙夫问于我	dkft
有笔头千字	dtup
游必有方	indy
有不得见者	dgtf
犹不见还家	qgmp
有不信焉	dgwg
有不虞之誉	dghi
有草名含羞	daqu
有车之用	dlpe
游城南	iffm
右丞相	dbsh
犹川谷之于江海	qkwi
由此观之	mhcp
有大人之事	ddwg
有大物者	ddtf
有怠而欲出者	dcdf
犹带昭阳日影来	qgjg
忧道不忧贫	nugw
有道难行不如醉	ducs
犹得备晨炊	qtto
有德者必有言	dtfy
又得浮生一日凉	ctiu
有弟皆分散	duxa
有丁不入军	dsgp
尤侗	dnwm
有东风	damq
幽独空林色	xqpq
忧端齐终南	nuyf
又多能也	cqcb
有杕之杜	dsps
有耳莫洗颍川水	dbai
又非君所详	cdvy
有匪君子	davb
有斐君子	ddvb
有蕡其实	daap
有风传雅韵	dmwu
有父兄在	dwkd
有妇颜如雪	dvuf
尤工远势古莫比	dafx
有洸有溃	didi
有鬼有神	drdp
有国有家者	dldf
有国之母	dlpx
又还被	cgpu
又何加焉	cwlg
有恨头还白	dnur
有恒产者有恒心	dnun
有狐	deqt
油葫芦	iaay
有狐绥绥	dqxx
有几个苍蝇碰壁	dmwn
幽涧泉	xiri
又见桐花发旧枝	cmss
又尽善也	cnub
游镜泊湖	iqii
又敬不违	cagf
有酒不饮奈明何	digw
有酒惟浇赵州土	dinf
幽居不用名	xngq
幽居在空谷	xndw
由君子观之	mvbp
有君子之道四焉	dvbg
犹堪一战取功勋	qfgk
犹可说也	qsyb
犹可逾也	qswb
又恐被	capu
犹恐巢中饥	qavq
犹恐失之	qarp
有口难言不如睡	dkch
犹来	qtgo
由来碧落银河畔	mggl
忧来其如何	ngaw
由来轻七尺	mgln
由来征战地	mgtf
幽兰露	xufk
幽兰在山谷	xudw
有礼者敬人	dpfw
游媚笔泉记	ivty
有美一人	dugw
有美一人兮	dugw
有美玉于斯	duga
犹蒙矜育	qacy
有民人焉	dnwg
忧民之忧者	nnpf
有名而无实	dqdp
有冥海者	dpif
有名万物之母	dqdx
有木名凌霄	dsqf
犹能簸却沧溟水	qcti
犹能夜夜气冲天	qcyg
有鸟有鸟	dqdq
游女长歌缓缓归	ivtj
有女如玉	dvvg
有女同行	dvmt
又其次也	caub
幽栖地僻经过少	xsfi
有其实	dapu
友其士之仁者	daff
犹其有四体也	qadb
有器之用	dkpe
犹且从师而问焉	qewg
幼卿	xlqt
有情而无形	dndg
有情风	dnmq
有求全之毁	dfwv
犹求友声	qfdf
犹去孤舟三四里	qfbj
有泉侧出	drwb
攸然而逝	wqdr
幽人归独卧	xwja
友人会宿	dwwp
游人几度菊花丛	iwmw
游人脚底一声雷	iwef
有人泣	dwiu
有人天游	dwgi
有人同病相怜	dwmn
游人武陵去	iwgf
由仁义行	mwyt
幽人应未眠	xwyh
有人于此	dwgh
有人之形	dwpg
有若对曰	dacj
有色同寒冰	dqmu
有杀身以成仁	dqtw
由山以上五六里	mmnj
有身莫犯飞龙鳞	dtaq
有神人居焉	dpwg
犹胜曲全钩	qemq
有时白云起	djrf
由是而言	mjdy
犹是孤帆一日程	qjbt
由是观之	mjcp
有时忽惆怅	djqn
有时空望孤云高	djpy
游石门涧	idui
又失其故行矣	crac
又食武昌鱼	cwgq
有是言也	djyb
由是言之	mjyp
有始也者	dvbf
有始有卒者	dvdf
有时遭孔穴	djgp
有室之用	dppe
右手举	driw
有手莫辫猛虎须	drae
幽树晚多花	xsja
有水一池	digi
犹水之就下	qipg
由水之就下	mipg
犹似霓裳羽衣舞	qwfr
有所不行	drgt
有所教	drft
有所希冀	drqu
犹沓沓也	qiib
犹听侍女唱梅花	qkwa
又未尝不可呢	cfik
犹为弃井也	qyyb
有谓无谓	dyfy
有为则亏	dymf
有为者亦若是	dyfj
又闻此语重唧唧	cuhk
又闻子规啼	cubk
又闻子规啼夜月	cube
犹吾大夫崔子也	qgdb
有物先天地	dttf
有席卷天下	dyug
悠兮其贵言	wway
犹兮若畏四邻	qwaw
又奚以自多	cenq
有仙山琼阁	dwmu
有小人之事	diwg
游谢氏山亭	iyqy
忧心忡忡	nnnn
忧心惙惙	nnnn
有心而为之	dndp
忧心孔疚	nnbu
忧心烈烈	nngg
忧心靡乐	nnyq
忧心钦钦	nnqq
忧心有忡	nndn
有形有名	dgdq
有雄文四卷	ddyu
有穴窈然	dppq
有颜回者好学	duli
有言者不必有德	dyft
由也好勇过我	mbvt
由也兼人	mbuw
幽咽泉流水下滩	xkri
由也升堂矣	mbtc
由也为之	mbyp
有毅力者成	duld
犹忆笙歌昨夜欢	qntc
忧以天下	nngg
幽意无断绝	xufx
有以异乎	dnnt
犹疑照颜色	qxjq
有翼自薄	dnta
幽映每白日	xjtj
悠悠苍天	wwag
悠悠隔九天	wwbg
悠悠湖上来	wwig
悠悠回赤壁	wwln
又有江山	cdim
有有令	ddwy
悠悠洛阳道	wwiu
悠悠梦里无寻处	wwst
幽幽南山	xxfm
悠悠生死别经年	wwtr
犹有所待者也	qdrb
悠悠天地间	wwgu
悠悠天宇旷	wwgj
犹有未树也	qdfb
悠悠我心悲	wwtd
又欲其死	cwag
游于天地	iggf
游于羿之彀中	ignk
犹缘木而求鱼也	qxsb
优哉悠哉	wfwf
悠哉悠哉	wfwf
右招我由房	drty
有志竟成	dfud
有志与力	dfgl
犹之与人也	qpgb
有志在四方	dfdy
又重之以修能	ctpc
幽州胡马客	xydp
幽州胡马客歌	xyds
有竹千竿	dttt
游子久不至	ibqg
犹自梦渔樵	qtss
有子七人	dbaw
游子思故乡	iblx
游子西	ibsg
犹自音书滞一乡	qtux
有罪不敢赦	dlgf
有罪无罪	dlfl
有左有右	dddd
于敖	gfgq
欲罢不能	wlgc
欲罢不能忘	wlgy
语罢暮天钟	ylaq
欲把一麾江海去	wrgf
庾抱	yvrq
玉抱肚	gref
欲报倾城随太守	wrwp
欲报之德	wrpt
郁彼北林	dtus
鴥彼晨风	wtjm
于彼郊矣	gtuc
鱼鳖不可胜食也	qugb
欲别频啼四五声	wkhf
欲别牵郎衣	wkdy
欲并老容羞白发	wufn
玉帛朝回望帝乡	grfx
玉帛云乎哉	grff
予不得视犹子也	cgtb
予不得已也	cgtb
鱼不可脱于渊	qgsi
欲持一瓢酒	wrgi
虞俦	hawd
御厨络绎送八珍	tdxg
余词尽废	wyny
于此泣无穷	ghip
于从政乎何有	gwgd
雨打归舟泪万行	frjt
御带花	tgaw
欲待曲终寻问取	wtmb
欲代子相	wwbs
玉珰缄札何由达	ggxd
欲得周郎顾	wtmd
余弟安国平父	wupw
雨滴梧桐秋夜长	fist
玉簟凉	gtuy
玉簟秋	gtto
玉殿虚无野寺中	gnhk
玉殿犹分下苑波	gnqi
玉斗一双	gugc
余独不觉	wqgi
欲渡谁相待	wiyt
欲而不贪	wdgw
与尔同消万古愁	gqmt
与尔同销万古愁	gqmt
鱼儿悬宝剑	qqew
鱼翻藻鉴	qtaj
于飞乐	gnqi
喻凫	kwqy
渔父	iqwq
欲拂尘时簟竟床	wriy
渔父乐	iwqi
渔歌入浦深	isti
庾公之斯	ywpa
欲苟顺私情	wakn
榆关断音信	suow
玉闺青门里	gugj
余桂英	wsam
雨过河源隔座看	ffir
余杭门外	wsuq
俞灏	wgij
予何人也	cwwb
雨后复斜阳	frtb
雨后全无叶底花	frwa
于鹄	gftf
玉壶冰	gfui
郁乎苍苍	dtaa
玉蝴蝶	gjja
玉虎牵丝汲井回	ghdl
玉壶吟	gfkw
欲呼张良与俱去	wkxf
玉花却在御榻上	gafh
谕怀	ywng
欲济苍生未应晚	wiaj
欲及时也	wejb
余既为此志	wvyf
欲寄相思千点泪	wpsi
欲祭疑君在	wwxd
渔家乐	ipqi
余嘉其能行古道	wfau
俞简	wgtu
庾肩吾	yygk
鱼见之深入	qmpt
于涧之中	gipk
预将书报家	cunp
玉交枝	gusf
于嗟乎	gktu
于嗟鸠兮	gkvw
于嗟阔兮	gkuw
于嗟麟兮	gkyw
于嗟女兮	gkvw
欲洁其身	wiat
玉阶生白露	gbtf
于嗟洵兮	gkiw
玉阶怨	gbqb
于今为庶为青门	gwyu
于今无会因	gwfl
玉筋应啼别离后	gtyr
于今知有谁	gwty
玉京群帝集北斗	gyvu
玉京谣	gyye
欲就麻姑买沧海	wyyi
余久卧病无聊	wqab
雨具先去	fhtf
欲卷珠帘春恨长	wugt
欲觉闻晨钟	wiuq
与君白黑大分明	gvrj
与君发三愿	gvnd
与君歌一曲	gvsm
与君世世为兄弟	gvau
与君营奠复营斋	gvay
与君永相望	gvyy
与可画竹时	gsgj
与客携壶上翠微	gprt
玉阑干	gufg
于兰何伤	guww
玉郎会此通仙籍	gywt
雨里鸡鸣一两家	fjcp
玉莲花	gaaw
玉连环	glgg
渔梁渡头争渡喧	iiik
于良史	gykq
雨淋铃	fiqw
于林之下	gspg
於陵论价重如金	ybyq
欲令诗语妙	wwyv
鱼龙寂寞秋江冷	qdpu
鱼龙听梵声	qdkf
玉漏迟	giny
玉楼春令	gsdw
玉漏莫相催	giaw
玉楼天半起笙歌	gsgs
庾楼晓望	ysjy
玉楼宴罢醉和春	gspd
雨落不上天	fagg
玉貌锦衣	geqy
玉梅令	gswy
虞美人令	huww
予美亡此	cuyh
玉门关	guud
禹庙空山里	typj
与命与仁	gwgw
虞某	haaf
於穆不已	ytgn
鱼目混珍	qhig
於穆清庙	ytiy
鱼馁而肉败	qqdm
玉辇纵横过主第	gfxt
玉女摇仙佩	gvrw
玉盘迸泪伤心数	gtuo
玉盘珍羞值万钱	gtgq
玉佩天涯远	gwgf
玉盆纤手弄清泉	gwxr
与朋友共	geda
与朋友交	gedu
欲辟土地	wnff
予岂好辩哉	cmvf
与其进也	gafb
与其媚于奥	gavt
与其奢也	gadb
于其身也	gatb
与其易也	gajb
欲其子之齐语也	wabb
于潜七兄	giak
鱼潜在渊	qidi
与亲	gnus
与秦始皇	gdvr
欲倾东海洗乾坤	wwaf
雨晴烟晚	fjoj
雨去花光湿	ffai
欲取鸣琴弹	wbkx
欲去去无由	wffm
欲去问西家	wfup
欲取芜城作帝家	wbap
欲去惜芳菲	wfna
欲去又还不去	wfcf
玉人歌	gwsk
与人恭而有礼	gwap
于人何所不容	gwwp
与人和者	gwtf
与人乐乐	gwqq
於人为可讥	ywyy
御人以口给	twnx
愚人之所以为愚	jwpj
玉容寂寞泪阑干	gppf
雨色秋来寒	fqtp
羽扇纶巾谈笑间	nyxu
与山间之明月	gmue
玉山颓	gmtm
玉山自倒非人推	gmtr
于邵	gfvk
与少乐乐	giqq
于是废先王之道	gjyu
与时俯仰	gjww
于是惠子恐	gjga
与时俱化	gjww
于是遂去	gjuf
于是饮酒乐甚	gjqa
欲曙	wwjl
玉树后庭花	gsra
欲书花叶寄朝云	wnaf
禹疏九河	tnvi
玉树琼花满目春	gsgd
羽书昨夜过渠黎	nnjt
玉水明沙	giji
与谁同	gymg
鱼水同欢	qimc
于斯三者何先	gadt
迂叟	gfvh
欲速成者也	wgdb
欲速则不达	wgmd
予所否者	crgf
宇泰定者	pdpf
玉台体	gcws
玉堂春	gidw
玉梯横绝月中钩	gssq
与天齐寿	ggyd
与天为徒	ggyt
与天为一	ggyg
欲投人处宿	wrwp
玉团儿	glqt
玉碗盛来琥珀光	gddi
欲往城南望城北	wtfu
欲忘忘未得	wyyt
与为人妻	gywg
余威震于殊俗	wdfw
欲问孤鸿向何处	wubt
欲问江南近消息	wuit
宇文融	pygk
渔翁	iqwc
渔翁夜傍西岩宿	iwyp
雨我公田	ftwl
于我归处	gtjt
于我如浮云	gtvf
於我心有戚戚焉	ytng
与物反矣	gtrc
予无乐乎为君	cfqv
予无所用天下为	cfry
雨无正	ffgh
玉玺不缘归日角	gqgq
雨洗东坡月色清	fiai
羽檄交驰日夕闻	nsuu
雨洗娟娟净	fivu
虞兮奈若何	hwdw
豫兮若冬涉川	cwak
虞兮虞兮奈若何	hwhw
鱼鲜饭细酒香浓	qqqi
欲献项王	wfag
馀响入霜钟	qktq
鱼相与处于陆	qsgb
鱼相造乎水	qsti
玉箫金管坐两头	gtqu
予小子履	cibn
雨歇杨林东渡头	fjsu
庾信平生最萧瑟	ywgg
庾信文章老更成	ywyd
舆薪之不见	wapm
欲行不行各尽觞	wtgq
鱼玄机	qysm
雨雪纷纷连大漠	ffxi
雨雪其雱	ffaa
玉雪为骨冰为魂	gfyf
雨雪载途	fffw
欲寻芳草去	wvaf
玉颜不及寒鸦色	gugq
玉颜憔悴三年	gunr
寓言十九	pyfv
余延寿	wtdt
于焉逍遥	ggie
寓言因永吟	pylk
揄扬九重万乘主	rrvy
渔阳鼙鼓动地来	ibfg
于邺	gfog
于以采蘩	gnea
余亦乘舟归鹿门	wytu
欲以菲薄明其衷	wnay
欲以观其徼	wnct
欲以观其妙	wncv
余亦能高咏	wyck
于以求之	gnfp
余亦谢时去	wyyf
予一以贯之	cgnp
于以用之	gnep
玉英	gyam
鱼游春水	qidi
鱼游沸鼎知无日	qiij
语有贵也	ydkb
与忧俱生	gnwt
玉宇澄清万里埃	gpif
御宇多年求不得	tpqt
予与尔言	cgqy
郁郁纷纷	ddxx
郁郁乎文哉	ddtf
鱼与龙同池	qgdi
与与如也	ggvb
愉愉如也	nnvb
欲与天公试比高	wggy
予欲无言	cwfy
欲与亚父	wggw
鱼鱼雅雅	qqaa
于予与改是	gcgj
于予与何诛	gcgy
郁郁园中柳	ddls
欲与之言	wgpy
御苑砧声向晚多	tadq
欲赠隔远天	wmbg
豫章行	cutf
于沼于沚	gigi
愚者与有焉	jfgg
予之不仁也	cpgb
语之而不惰者	ypdf
予之力尚足以入	cplt
于志宁	gfps
语之所贵者	yprf
与之同命	gpmw
雨中春树万人家	fkdp
雨中花	fkaw
雨中花令	fkaw
雨中花慢	fkan
雨中黄叶树	fkas
雨中禁火空斋冷	fksu
与众乐乐	gwqq
雨中寥落月中愁	fkpt
雨中山果落	fkma
域中有四大	fkdd
雨中作	fkwt
宇宙内事	ppmg
渔舟逐水爱山春	ited
予助苗长矣	ceac
玉烛新	gous
玉箸应啼别离后	gtyr
欲诛有功之人	wydw
玉竹斩	gtlr
与诸子登岘山	gybm
欲妆临镜慵	wujn
寓庄于谐	pygy
余自束发	wtgn
与子同仇	gbmw
与子同袍	gbmp
与子同裳	gbmi
与子同泽	gbmi
与子偕行	gbwt
与子偕臧	gbwd
与子偕作	gbww
俞紫芝	whap
雨足郊原草木柔	fkuc
远岸秋沙白	fmtr
员半千	kutf
愿陛下矜愍愚诚	dbgy
远别离	fkyb
愿补舜衣裳	dpei
怨不在大	qgdd
圆禅师	lpjg
远朝归	ffjv
愿乘泠风去	dtif
愿成双	ddcc
远耻辱也	fbdb
元淳	fqiy
怨春风	qdmq
怨春归	qdjv
怨词	qbyn
元丹丘	fmrg
远道不可思	fugl
愿得此身长报国	dthl
愿得天子知	dtgt
爰得我所	ettr
爰得我直	ettf
愿得燕弓射大将	dtau
愿得斩马剑	dtlw
缘督以为经	xhnx
远放燕支山下	fyag
远方之人	fypw
元孚	fqeb
愿夫子辅吾志	dfbf
圆荷浮小叶	laik
元和令	ftwy
元和十年	ftfr
元和天子神武姿	ftgu
元晦	fqjt
元寂	fqph
元季川	ftkt
冤家今夜醉	ppws
缘涧还复去	xigf
元绛	fqxt
愿将腰下剑	duew
袁郊	fkuq
元结	fqxf
愿接卢敖游太清	drhi
爰居爰处	enet
愿君学长松	dvis
远看方知出处高	fryy
缘路	xxkh
远路应悲春晼晚	fkyj
远梦归侵晓	fsjj
猿鸣天上哀	qkgy
猿鸣钟动不知曙	qkqj
渊默而雷声	ildf
远莫致之	fagp
远目非春亦自伤	fhdw
缘木求鱼	xsfq
猿猱欲度愁攀援	qqwr
猿鸟犹疑畏简书	qqqn
圆魄上寒空	lrhp
愿乞终养	dtxu
源乾曜	ifjn
垣墙周庭	ffmy
怨情	qbng
原壤夷俟	dfgw
圆如用智	lvet
怨三三	qddg
爰丧其马	efac
愿扫鹦鹉洲	drmi
远山晴更多	fmjq
元晟	fqjd
猿声不喘鱼龙听	qfgk
猿声天上哀	qfgy
远师	fqjg
怨是用希	qjeq
远树带行客	fsgp
袁恕己	fvnn
愿书万本诵万过	dndf
远送从此别	fuwk
远送于南	fugf
远送于野	fugj
愿随春风寄燕然	dbdq
愿随孤月影	dbbj
远隋流水香	fbit
远随流水香	fbit
袁綯	fkxq
猿啼洞庭树	qkis
猿啼客散暮江头	qkpu
远听明君爱逸才	fkjf
愿同尘与灰	dmid
愿同尧舜意	dmau
元万顷	fdxd
怨王孙	qgbi
愿为持竿叟	dyrv
远慰风雨夕	fnmq
愿为双鸿鹄	dyct
愿为小相焉	dyig
愿闻子之志	dubf
愿无伐善	dfwu
沅湘流不尽	iiin
爰笑爰语	etey
远信入门先有泪	fwti
愿言思伯	dylw
愿言思子	dylb
愿言则怀	dymn
鸳鸯不独宿	qmgp
鸳鸯会双死	qmwg
鸳鸯梦	qmss
鸳鸯瓦冷霜华重	qmgt
鸳鸯相对浴红衣	qmsy
愿以境内累矣	dnfc
元遗山	fkmm
爰有树檀	edss
园有桃	ldsi
远于将之	fgup
元载	fqfa
元稹	fqtf
爰整其旅	egay
远之事君	fpgv
援之以道	rpnu
远之则怨	fpmq
愿作深山木	dwis
愿作鸳鸯不羡仙	dwqw
月暗	eeju
月傍九霄多	ewvq
月边娇	elvt
月城春	efdw
月出	eebm
月出峨眉照沧海	ebmi
月出寒通雪山白	ebpr
月出皎兮	ebrw
月出于东山之上	ebgh
月出照兮	ebjw
月出之光	ebpi
约从离衡	xwyt
月当窗	eipw
月点波心一颗珠	ehig
月殿影开闻夜漏	enji
月儿高	eqym
约而为泰	xdyd
岳甫	rgge
月赋	eemg
越妇言	fvyy
月宫春	epdw
月光长照金樽里	eitj
曰归曰归	jjjj
月寒秋竹冷	eptu
月华清	ewig
阅江楼记	uisy
越江吟	fikw
乐节礼乐	qapq
阅金经	uqxc
阅尽人间春色	unwq
月露谁教桂叶香	efyt
月落潮平是去时	eaij
月落锦屏虚	eaqh
月落星稀天欲明	eajj
月慢	eenj
月明白鹭飞	ejrn
月明荞麦花如雪	ejaf
月明松下房栊静	ejsg
月明欲素愁不眠	ejwh
月明征虏亭	ejty
越娘	fhvy
越鸟巢干后	fqvr
越女镜心	fvqn
越女天下白	fvgr
月攘一鸡	ergc
越人语天姥	fwyv
月如水	evii
月色入户	eqty
跃上葱茏四百旋	khay
月上海棠	ehii
约他年	xwrh
月兔空捣药	eqpa
越王勾践破吴归	fgqj
约为婚姻	xyvv
越巫	fhaw
月无忘其所能	efyc
越溪寒	fipf
月溪明	eije
月下独酌四首	egqu
月下起舞	egfr
曰下学	jgip
月榭故香因雨发	esdn
月斜楼上五更钟	ewsq
约心	xqny
月行却与人相随	etfb
岳阳楼	rbso
岳阳楼上对君山	rbsm
月夜忆舍弟	eynu
趯趯阜螽	ffwt
月照城头乌半飞	ejfn
月照梨花	ejta
月照平沙夏夜霜	ejgf
月照一孤舟	ejgt
乐正	qigh
月中桂	eksf
月中行	ektf
越中览古	fkjd
越中山色镜中看	fkmr
云傍马头生	fwct
云边雁断胡天月	flde
云表	fcge
云鬓半偏新睡觉	fdui
云鬓花颜金步摇	fdar
云此最吉馀难同	fhjm
云淡秋空	fitp
云峰水隔深	fmii
云和	fctk
云横九派浮黄鹤	fsvp
云胡不瘳	fdgu
云胡不夷	fdgg
云黄雉兔伏	fatw
云髻罢梳还对镜	fdlq
云间连下榻	fuls
云将东游	fuai
运斤成风	frdm
云卷千峰色	futq
云开衡岳积阴止	fgth
云开远见汉阳城	fgff
云来气接巫峡长	fgrt
云里帝城双凤阙	fjuu
韵令	ujwy
云龙风虎尽交回	fdml
云埋伏兽丛	ffww
云满湖	fiid
云门寺	fuff
运命唯所遇	fwkj
运命惟所遇	fwnj
云霓明灭或可睹	ffjh
云青青兮欲雨	fggf
云容	fcpw
云散月明谁点缀	faex
云山况是客中过	fmuf
云山乱	fmtd
云山万重	fmdt
云谁之思	fypl
云外惊飞四散哀	fqny
云物不殊乡国异	ftgn
云雾敛	ffwg
云溪友议	fidy
云霞生薜帷	fftm
云想衣裳花相容	fsyp
云阳上征去	fbhf
运移汉祚终难复	ftit
云雨荒台岂梦思	ffal
愠于群小	ngvi
云雨巫山枉断肠	ffae
云在意俱迟	fdun
云栈萦纡登剑阁	fsau
云之际	fpbf
允执其中	crak
云中君不见	fkvm
韵资天纵	uugx
云自无心水自闲	ftfu
杂佩以赠之	vwnp
杂申椒与菌桂兮	vjsw
杂诗七首	vyau
再拜而送之	grdp
再拜稽首	grtu
再拜献大王足下	grfg
在邦必达	ddnd
在邦必闻	ddnu
在邦无怨	ddfq
在彼空谷	dtpw
在彼中河	dtki
在长安	dtpv
在长空	dtpw
在陈绝粮	dbxo
载沉载浮	fifi
在城阙兮	dfuw
载驰	facb
在德不在险	dtgb
宰割天下	ppgg
在桂林	dsss
载好其音	fvau
在好为人师	dvyj
载饥载渴	fqfi
在家必达	dpnd
在家必闻	dpnu
在家常早起	dpif
在家出家	dpbp
再加牛肉	glrm
在家无怨	dpfq
载渴载饥	fifq
载弄之璋	fgpg
在其板屋	dasn
载寝之床	fppy
载驱	faca
在人不在天	dwgg
在山泉水清	dmri
再使风俗淳	gwmi
宰我对曰	ptcj
宰我问曰	ptuj
在我学子	dtib
在夏后之世	ddra
载笑载言	ftfy
在新丰鸿门	dudu
载玄载黄	fyfa
载营魄抱一	farg
在予一人	dcgw
在狱咏蝉并序	dqky
载舟覆舟	ftst
赞成功	tdal
暂将弓并曲	luxm
暂凭樽酒送无憀	lwsn
赞浦子	tibb
暂时分手莫踌躇	ljwk
暂时相赏莫相违	ljsf
暂引樱桃破	lxsd
暂游桃源里	lisj
葬之以礼	apnp
早被婵娟误	jpvy
早蝉	jhju
早朝	jhfj
早出晚归	jbjj
早春	jhdw
早春寄王汉阳	jdpb
早春晚归	jdjj
早春怨	jdqb
造次必于是	tunj
遭此两重阳	ghgb
早冬	jhtu
早服还丹无世情	jegn
早服谓之重积德	jeyt
早归	jhjv
早归来	jjgo
早寒	jhpf
凿户牖以为室	oytp
枣花未落桐叶长	gaft
糟糠养贤才	oouf
早梅芳	jsay
早秋	jhto
早秋惊落叶	jtnk
早热	jhrv
遭时徽纆	gjtx
早晚复相逢	jjtt
早晚下三巴	jjgc
早望海霞边	jyil
早兴	jhiw
早雁拂银河	jdri
早已森严壁垒	jnsc
躁则失君	kmrv
早知潮有信	jtiw
早知如此悔归来	jtvg
则哀矜而勿喜	mycf
泽陂	icbh
择不处仁	rgtw
则不能也	mgcb
则不弃也	mgyb
则尝闻之矣	miuc
责臣逋慢	gagn
则臣视君如腹心	mapn
则耻师焉	mbjg
则冻馁其妻子	muqb
则告诉不许	mtyy
则何以哉	mwnf
则或咎其欲出者	matf
泽及天下	iegg
泽及万物	iedt
则将焉用彼相矣	mugc
则芥为之舟	mayt
则可谓云尔已矣	msyc
泽梁无禁	iifs
则民不服	mnge
则民不敬	mnga
则民不偷	mngw
则民莫敢不服	mnae
则民莫敢不敬	mnaa
则民莫敢不用情	mnan
则民易使也	mnjb
则难	mjcw
仄平	dwgu
仄平平	dggu
仄平平仄	dggd
仄平平仄平	dggg
仄平平仄仄	dggd
仄平平仄仄平	dggg
仄平平仄仄平平	dggg
仄平仄	dgdw
仄平仄仄	dgdd
仄平仄仄平	dgdg
仄平仄仄平平仄	dgdd
仄平仄仄仄平平	dgdg
则仆偿前辱之责	mwwg
则齐国其庶几乎	mylt
则其至又加少矣	magc
则群聚而笑之	mvbp
责任重于泰山	gwtm
则如之何	mvpw
择善而从之	rudp
择师而教之	rjdp
则是方四十里	mjyj
则庶人不议	mywy
则为官长	mypt
则为之也难	mypc
则吾必在汶上矣	mgnc
则无不治	mfgi
则吾从先进	mgwf
则无恒产	mfnu
则吾能征之矣	mgcc
则吾岂敢	mgmn
则修文德以来之	mwyp
则学孔子也	mibb
则易	mjjq
则移其民于河东	mtaa
则以学文	mniy
则游者众	mifw
则与斗卮酒	mgui
则远怨矣	mfqc
仄韵	dwuj
仄仄平	ddgu
仄仄平平	ddgg
仄仄平平平仄	ddgd
仄仄平平平仄仄	ddgd
仄仄平平仄	ddgd
仄仄平平仄仄	ddgd
仄仄平平仄仄平	ddgg
仄仄仄	dddw
仄仄仄平	dddg
仄仄仄平平	dddg
仄仄仄平平仄仄	dddd
仄仄仄仄	dddd
仄仄仄仄仄	dddd
仄仄仄仄仄仄	dddd
仄仄仄仄仄仄仄	dddd
则政不在大夫	mggf
则智者尽其谋	mtfy
则至者少	mgfi
则足以拒秦	mknd
贼平后送人北归	mgrj
贼退示官吏并序	mvfy
贼义者谓之残	myfg
怎么得了	tttb
赠别二首	mkfu
赠丁玲	msgw
赠荷花	maaw
赠君从此去	mvwf
赠君一法决狐疑	mvgx
赠梁汾	miiw
赠梦得	mstj
赠孟浩然	mbiq
赠内	mumw
赠内人	mmww
赠裴十四	mdfl
赠阙下裴舍人	mugw
赠卫八处士	mbwf
赠言	muyy
赠远虚盈手	mfhr
赠张丞相	mxbs
曾子言曰	ubyj
曾子有疾	ubdu
乍见翻疑梦	tmts
乍将云岛极	tufs
乍可狂歌草泽中	tsqk
札札弄机杼	ssgs
摘得新	rtus
摘红英	rxam
摘花不插发	ragn
斋戒	ydaa
斋居	ydnd
摘来沽酒君肯否	rgig
摘莲花	raaw
战罢沙场月色寒	hlip
湛贲	iafa
瞻彼淇奥	htit
瞻彼日月	htje
战必胜矣	hnec
战场白骨缠草根	hfrs
斩长鲸	ltqg
战城南	hffm
占春芳	hday
战地黄花分外香	hfat
瞻顾遗迹	hdky
沾襟比散丝	ipxx
湛露	iafk
战马欲南归	hcwj
斩木为兵	lsyr
展如之人兮	nvpw
战士指看南粤	hfrt
瞻望弗及	hyxe
詹玉	qdgy
战则必胜	hmne
战战兢兢	hhdd
瞻之在前	hpdu
辗转念前途	llww
张安石	xpdg
章八元	uwfq
张白	xtrr
张昪	xtjc
张表臣	xgah
张伯寿	xwdt
张伯英	xwam
张昌宗	xjpf
长成须读五车书	tden
张楚金	xsqq
张辞	xttd
张丛	xtww
张大安	xdpv
长大一相逢	tdgt
张道符	xutw
长得君王带笑看	ttvr
张顶	xtsd
张杜	xtsf
张谔	xtyk
张风子	xmbb
丈夫非无泪	dfdi
丈夫何事足萦怀	dfwn
丈夫未可轻年少	dffi
张复元	xtfq
张纲	xtxm
张格	xtst
张观	xtcm
张光朝	xifj
张衮	xtuc
涨海积稽天	iitg
张弘靖	xxug
张祜	xtpy
章华即旧台	uwvc
张怀庆	xnyd
张汇	xtia
张翚	xtnp
张浑	xtip
张垍	xtft
张籍	xttd
张继	xtxo
张贾	xtsm
张嘉贞	xfhm
张渐	xtil
张建封	xvff
仗剑行千里	wwtj
章楶	ujuq
章碣	ujdj
张景修	xjwh
张景源	xjid
张敬斋	xayd
张敬忠	xakh
张九龄	xvhw
张矩	xttd
张莒	xtak
张扩	xtry
张郎中	xykh
张耒	xtdi
杖藜徐步立芳洲	sati
杖藜徐步转斜阳	satb
张良臣	xyah
张良璞	xygo
张良西向侍	xysw
张濛	xtia
张泌	xtin
张幕会连沙	xawi
张南史	xfkq
障泥未解玉骢骄	bifc
张蠙	xtjp
张绮	xtxd
张起	xtfh
张齐贤	xyjc
张乔	xttd
张钦敬	xqaq
张仁宝	xwpg
张任国	xwlg
张仁溥	xwig
张少博	xifg
张绍文	xxyy
张生手持石鼓文	xtry
张胜之	xepp
张拭	xtra
张时	xtjf
张轼	xtla
张十八	xfwt
张师师	xjjg
张署	xtlf
张叔良	xhyv
张叔卿	xhqt
张说	xtyu
章四句	ulqk
张随	xtbd
张太华	xdwx
章台柳	ucsq
章台夜思	ucyl
张焘	xtdt
张万顷	xdxd
张谓	xtyl
张文琮	xygp
张文恭	xyaw
张文姬	xyva
张文收	xynh
张昔	xtaj
章孝标	ufsf
张孝忠	xfkh
张协	xtfl
张修之	xwpp
张旭	xtvj
张旭三杯草圣传	xvdw
张宣明	xpje
张演	xtip
张义方	xyyy
张幼谦	xxyu
张友仁	xdwf
张又新	xcus
张友正	xdgh
长幼之节	txpa
张聿	xtvf
张元一	xfgg
张元宗	xfpf
张韫	xtfn
张云容	xfpw
张宰	xtpu
长在汉家营	tdia
张藻	xtai
长者虽有问	tfku
张轸	xtlw
张正一	xggg
张正元	xgfq
张直	xtfh
张志和	xftk
张仲方	xwyy
张仲谋	xwya
张仲素	xwgx
张仲孝友	xwfd
张仲宇	xwpg
张濯	xtin
张孜	xtbt
张子容	xbpw
张佐	xtwd
赵昂	fhjq
赵必	fhnt
朝不虑夕	fghq
招潮	rvif
朝辞白帝彩云间	ftru
赵冬曦	ftju
赵铎	fhqc
赵防	fhby
昭告列祖	jtgp
朝歌夜弦	fsyx
召公谏厉王弭谤	vwyy
赵嘏	fhdn
赵光逢	fitd
照横塘半天残月	jsfe
召忽死之	vqgp
赵骅	fhcw
赵惠宗	fgpf
照见人如画	jmwg
照镜	jvqu
朝菌不知晦朔	fagu
昭君怨	jvqb
招客	rvpt
赵客缦胡缨	fpxx
照梁初有情	jipn
赵良玉	fygy
照临下土	jjgf
赵令畤	fwlf
召门弟子曰	vuuj
赵孟谦	fbyu
召南	vkfm
赵企	fhwh
照日深红暖见鱼	jjiq
赵汝钠	fiqm
朝如青丝暮成雪	fvgf
赵汝愚	fijm
赵瑟初停凤凰柱	fgps
赵士暕	ffjg
赵师侠	fjwg
诏书切峻	ynam
诏书特下	yntg
诏书五道出将军	yngp
照水红蕖细细香	jixt
昭王白骨萦蔓草	jgra
诏谓将军拂绢素	yyug
赵微明	ftje
赵武建	fgvf
赵希	fhqd
赵希明	fqje
肇锡余以嘉名	yqwq
诏下	yvgh
朝霞晴作雨	ffjf
赵湘	fhis
招寻独有君	rvqv
赵彦伯	fuwr
赵延寿	ftdt
赵彦昭	fujv
昭阳殿里第一人	jbnw
昭阳殿里恩爱绝	jbnx
昭阳殿下捣衣声	jbnf
照野弥弥浅浪	jjxi
赵壹	fhfp
照映里门非白屋	jjjn
赵有平原	fdgd
赵与	fhgn
照在绿波中	jdxk
朝朝空自归	ffpj
朝朝马策与刀环	ffcg
朝朝暮暮催疲老	ffaf
朝朝暮暮在眼前	ffau
朝朝暮暮主人耳	ffab
朝朝误妾期	ffya
招招舟子	rrtb
朝朝醉中去	ffsf
赵子发	fbnt
赵宗儒	fpwf
折彼荷花	rtaa
折丹桂	rmsf
浙东飞雨过江来	iang
这个是甚麽	ywjy
鹧鸪词	ydyn
折桂令	rswy
折红梅	rxst
折红英	rxam
折花令	rawy
折花门前剧	raun
折戟沈沙铁未销	rfiq
折剑头	rwud
浙江八月何如此	iiwh
谪居	yund
谪居卧病浔阳城	ynaf
折柳枝	rssf
折藕爱连丝	raex
谪戍之众	ydpw
谪仙怨	ywqb
折杨柳	rssq
珍宝尽有之	gpnp
振长策而御宇内	rttm
砧杵夜千家	dsyp
贞妇贵殉夫	hvkf
朕躬有罪	etdl
甄后	sfrg
朕皇考曰伯庸	erfy
真金在	fqdh
真堪托死生	ffrt
珍娘	gwvy
真娘墓	fvaj
真人之息以踵	fwpk
枕上片时春梦中	shtk
枕上作	shwt
砧声近报汉宫秋	dfrt
枕石待云归	sdtj
真是英雄一丈夫	fjaf
镇西	qfsg
针线犹存未忍开	qxqg
振于无竟	rgfu
真源了无取	fibb
真丈夫	fdfw
振振公姓	rrwv
振振公子	rrwb
振振公族	rrwy
振振君子	rrvb
振振兮	rrwg
振之以威怒	rpnv
镇之以无名之朴	qpns
真珠帘	fgpw
珍珠令	ggwy
郑遨	udgq
郑璧	udnk
郑伯克段于鄢	uwdg
征部乐	tuqi
郑常	udip
郑巢	udvj
争城以战	qfnh
正当今夕断肠处	giwt
正得秋而万宝成	gttd
争地以战	qfnh
争渡争渡	qiqi
整顿衣裳起敛容	ggyp
郑愕	udnk
郑昉	ud
郑风	udmq
正风雨	gmfg
郑馥	udtj
征夫怀远路	tfnk
正复为奇	gtyd
郑刚中	umkh
争割地而赂秦	qpfd
郑谷	udww
郑轨	udlv
郑颢	udjy
郑合	udwg
政何君而莫与	gwvg
郑洪业	uiog
郑昈	udjy
争教红粉不成灰	qfxd
郑据	udrn
蒸藜炊黍饷东菑	aaoa
征路此相逢	tkht
郑启	udyn
正憔悴	gnny
郑綮	udyn
征人蓟北空回首	twau
征人倚戍楼	twws
征人一望乡	twgx
征人怨	twqb
峥嵘赤云西	mmfs
峥嵘如鬼工	mmva
郑善玉	uugy
郑绍	udxv
郑少微	uitm
郑审	udpj
郑史	udkq
郑适	udtd
正是长安花落时	gjtj
正是去年	gjfr
正是四国	gjll
郑世翼	uanl
郑庶	udya
郑损	udrk
郑颋	udtf
征途未尽马蹄尽	twfn
正为鸥盟留醉眼	gyah
郑闻	udub
争向石崇家	qtdp
郑獬	udqt
郑雪岩	ufmd
郑严	udgo
郑愔	udnu
郑絪	udxl
郑俞	udwg
郑愚	udjm
郑余庆	uwyd
郑馀庆	uqyd
郑元秀	ufte
正月崇让宅	gemp
正月繁霜	getf
正月时	gejf
正月十三日	gefj
正月野花开	gejg
正月元日	gefj
征战无已时	thfj
征招	tgrv
政者正也	gfgb
铮铮然有京都声	qqqf
正值儿童弄钓舟	gwqt
正直元因造化功	gffa
郑准	uduw
郑子玉	ubgy
治安疏	ipnh
置杯焉则胶	lsge
陟彼崔嵬	btmm
陟彼高冈	btym
陟彼砠矣	btdc
陟彼南山	btfm
置彼周行	ltmt
直不百步耳	fgdb
知不可乎骤得	tgst
知不足则欺	tgka
知常曰明	tijj
雉朝飞	tfnu
治成德备	idtt
咫尺应须论万里	nnyj
直出浮云间	fbiu
知出乎争	tbtq
纸船明烛照天烧	xtjo
至大至刚	gdgm
直道而事人	fudw
直到门前溪水流	fgui
直道相思了无益	fusu
至道之极	gups
至道之精	gupo
执德不弘	rtgx
只得徐妃半面妆	kttu
知德者鲜矣	ttfc
至德之世	gtpa
指点江山	rhim
志定	fnpg
直而不肆	fdgd
之二虫又何知	pfjt
直而无礼则绞	fdfx
织妇词	xvyn
雉雊麦苗秀	tqgt
执古之道	rdpu
志怪者也	fnfb
治国经邦	ilxd
治国去之	ilfp
知好色则慕少艾	tvqa
知和而和	ttdt
知和曰常	ttji
陟岵	bhmd
指挥若定	rrap
指挥若定失萧曹	rrag
只几个石头磨过	kmwf
至今窥牧马	gwpc
只今惟有温泉水	kwni
只今惟有西江月	kwne
只今惟有鹧鸪飞	kwnn
至今犹忆李将军	gwqp
卮酒安足辞	ript
置酒长安道	litu
指九天以为正兮	rvgw
志决身歼军务劳	futa
知君穿不得	tvpt
知君为我	tvyt
知君销不得	tvqt
致君尧舜	gvae
致君尧舜上	gvah
只恐流年暗中换	kair
只恐夜深花睡去	kayf
直栏横槛	fsss
芝兰其室	auap
至乐无乐	gqfq
支离东北风尘际	fyab
至丽物难掩	ggtr
支离笑此身	fytt
智亮	tdyp
滞虑洗孤清	ihii
知谋不用	tyge
直匍匐而归耳	fqqb
知其不可	tags
知其惑者	taaf
知其愚者	tajf
指穷于为薪	rpga
至人	gcww
治人事天	iwgg
至仁无亲	gwfu
治人者食於人	iwfw
知人之所为者	twpf
指如削葱根	rvis
之三子告	pdbt
直上三十里	fhdj
质胜文则野	reyj
志士不忘在沟壑	ffgh
只是当时已惘然	kjiq
知是故人来	tjdg
志士嗟日短	ffkt
志士仁人	ffww
知世如梦无所求	tavf
只识弯弓射大雕	kyym
知是萧郎至	tjag
志士幽人莫怨嗟	ffxk
知识最为贤	tyjj
执手分道去	rrwf
炙手可热势绝伦	qrsw
之死矢靡它	pgtp
直台	fhck
致万乘之势	gdtr
知忘是非	tyjd
知味良独少	tkyi
只为馨香重	kyft
直为斩楼兰	fylu
至微至陋	gtgb
知我者其天乎	ttft
知误会前番书语	tywy
知误会前翻书语	tywy
直下龙岩上杭	fgds
直下骑才通	fgcc
知向谁边	ttyl
知玄	tdyx
指巡胡	rvde
卮言日出	ryjb
至阳赫赫	gbff
至扬州	gryt
只要肯登攀	kshs
知业	tdog
知音不易得	tugt
知音世所稀	tuat
至阴肃肃	gbvv
只应是	kyjg
只应守寂寞	kypp
至于暴矣	ggjc
至于北海	ggui
至于成立	ggdu
至于顿丘	gggr
志与秋霜洁	fgti
至于犬马	ggdc
治於人者食人	iyww
直欲数秋毫	fwoy
至于他邦	ggwd
至誉无誉	gifi
至于兄弟	ggku
致远恐泥	gfai
只缘妖雾又重来	kxvg
只在芦花浅水边	kdal
直在其中矣	fdac
直哉史鱼	ffkq
至则行矣	gmtc
知章骑马似乘船	tuct
智者必怀仁	tfnw
知者不失人	tfgw
智者可卷愚者豪	tfsy
知者乐水	tfqi
知者利仁	tftw
执者失之	rfrp
质真若渝	rfai
只争朝夕	kqfq
直至长风沙	fgti
知之次也	tpub
智之端也	tpub
质直而好义	rfdy
置之河之侧兮	lpiw
置之河之干兮	lpiw
知止可以不殆	thsg
秩秩斯干	ttaf
直指武夷山下	frgg
枝枝相覆盖	sssu
知止则不殆	thmg
治之至也	ipgb
置之坐上	lpwh
雉子斑	tbgy
之子归	pbjv
稚子呼牛归	tbkj
止子路宿	hbkp
之子期宿来	pbag
稚子敲针作钓钩	tbyq
之子无裳	pbfi
之子于归	pbgj
直走咸阳	ffdb
知足少欲	tkiw
知足者富	tkfp
至尊含笑催赐金	guwq
终罢斯结庐	xlay
重比翼	txnl
仲并	wkua
终不解矣	xgqc
终不可用	xgse
中朝大官老于事	kfdg
终风	xtmq
终风且暴	xmej
终风且霾	xmef
终风且曀	xmej
重感	tgdg
忠告而善道之	ktdp
仲弓问仁	wxuw
终苟免而不怀仁	xaqw
中冓之言	kfpy
终古垂杨有暮鸦	xdta
钟鼓楼中刻漏长	qfst
中谷有蓷	kwda
钟鼓云乎哉	qfff
钟鼓之音	qfpu
钟鼓馔玉不足贵	qfqk
种瓜黄台下	trag
终归大海作波涛	xjdi
中贵多黄金	kkqq
中国之民	klpn
中涵孤月明	kibj
终和且平	xteg
种禾终不生豆苗	ttxa
中华儿女多奇志	kwqf
中华民族的	kwnr
重积德则无不克	tttd
终见降王走传车	xmbl
众狙皆怒	wqxv
众狙皆悦	wqxn
众口铄金君自宽	wkqp
终老不复取	xfgb
钟离春	qydw
钟离权	qysc
种荔枝	tasf
钟辂	qklt
众毛飞骨	wtnm
重门深锁无寻处	tuit
钟谟	qkya
种木不种德	tsgt
终南别业	xfko
终南何有	xfwd
中男绝短小	klxi
终南山	xfmm
终南望馀雪	xfyf
终南阴岭秀	xfbt
仲尼厄而作春秋	wndt
仲尼适楚	wnts
仲尼焉学	wngi
仲尼语之以为博	wnyf
仲尼之徒	wnpt
众鸟欣有托	wqrr
钟期久已没	qaqi
钟蒨	qkaw
中秋月	ktee
众人皆有以	wwxn
众人匹之	wwap
众人熙熙	wwaa
中人以上	kwnh
中人以下	kwng
众人重利	wwtt
终日坎壈缠其身	xjft
终日看山不厌山	xjrm
钟山风雨起苍黄	qmma
众山遥对酒	wmei
终身不得	xtgt
终身不解	xtgq
终身不离	xtgy
终身不勤	xtga
终身不忘	xtgy
众生心水净	wtnu
中使频倾赤玉盘	kwht
仲氏任只	wqwk
中士闻道	kfuu
终是悠悠行路心	xjwn
忠恕而已矣	kvdc
种树郭橐驼传	tsyw
仲叔圉治宾客	whlp
螽斯羽	tann
终岁不闻丝竹声	xmgf
中岁颇好道	kmhu
重题	tgjg
中天摧兮力不济	kgri
中天悬明月	kgee
中天月色好谁看	kger
中庭桃李映琐窗	kysp
中途不进	kwgf
重帷深下莫愁堂	tmii
重为乡党所笑	tyxt
终温且惠	xieg
仲夏苦夜短	wdat
终鲜兄弟	xqku
中宵劳梦想	kpas
中心如噎	knvk
中心如醉	knvs
中心是悼	knjn
中心摇摇	knrr
忠信之薄	kwpa
中央乐	kmqi
中夜四五叹	kylk
中隐	khbq
中庸之为德也	kypb
重有感	tddg
重有金樽开	tdqg
中有双飞鸟	kdcq
中有酥与饴	kdsq
中有一人字太真	kdgf
忠欲事明主	kwgy
重与细论文	tgxy
中原一败势难回	kdgl
终则有始	xmdv
众中不敢分明语	wkgy
冢中人	pkww
种种在其中	ttdk
种竹	tktt
仲子陵	wbbf
周伯阳	mwbj
洲长多暮归	itqj
周彻	mfta
舟车之所通	tlpc
周墀	mffn
周存	mfdh
周纲凌迟四海沸	mxui
周格非	msdj
周公恐惧流言后	mwar
周公作	mwwt
周行而不殆	mtdg
周弘亮	mxyp
周济川	mikt
舟楫恐失坠	tsab
州家申名使家抑	ypjr
周监于二代	mjgw
昼锦堂	nqip
周利用	mtet
周朴	mfsh
昼寝	nypu
周秦行纪	mdtx
舟人夜语觉潮生	twyt
周任有言曰	mwdj
舟人指点到今疑	twrx
周申	mfjh
州司临门	ynju
周虽旧邦	mkhd
周昙	mfjf
周渭	mfil
昼卧	nyah
周庠	mfyu
周彦晖	mujp
周彦昭	mujv
周繇	mfer
昼夜勤作息	nyat
周因于殷礼	mlgp
骤雨不终日	cfgj
骤雨打新荷	cfra
纣之不善	xpgu
舟中读元九诗	tkyy
周忠介公遗事	mkwg
舟中晓望	tkjy
周铢	mfqr
周祚	mfpy
朱褒	riyw
珠箔飘灯独自归	gtsj
珠箔银屏迤逦开	gtqg
住不得	wgtj
主称会面难	ytwc
筑城去	tffc
竹窗	ttpw
朱存	ridh
竹簟	ttts
朱敦复	rytj
朱敦儒	rywf
朱放	riyt
主歌悲顾鹤	ysdp
诸葛大名垂宇宙	yadp
诸葛孔明起陇中	yabk
诸公碌碌皆余子	ywdb
诸侯不得友	ywgd
诸侯不仁	ywgw
诸侯放恣	ywyu
诸侯尽西来	ywng
诸侯恐惧	ywan
诸侯之礼	ywpp
朱涣	riiq
朱晦	rijt
朱绛	rixt
竹解心虚即我师	tqnj
住近湓江地低湿	wrii
驻景挥戈	cjra
竹径通幽处	ttct
朱景文	rjyy
朱景玄	rjyx
朱均	rifq
诸君何以答升平	yvwg
竹开霜后翠	tgfn
逐客无消息	epft
朱逵	rifw
珠泪阑干	giuf
伫立以泣	wuni
珠帘不卷夜来霜	gpgf
珠帘卷	gpud
珠帘暮卷西山雨	gpaf
竹怜新雨后	tnur
竹凉侵卧内	tuwm
株林	srss
竹露滴清响	tfik
驻马别孤坟	cckf
竹马车	tclg
竹马儿	tcqt
驻马听	cckr
驻马望千门	ccyu
驻马衔杯问谪居	cctn
朱买臣	rnah
朱门先达笑弹冠	rutp
朱穆	ritr
祝穆	pytr
竹批双耳峻	trcm
祝钦明	pqje
朱庆余	rywt
朱庆馀	ryqn
注然勃然	iqfq
主人不相识	ywgy
主人何为言少钱	ywwq
主人忘归客不发	ywyn
主人下马客在船	ywgt
主人有酒欢今夕	ywdq
朱蕤冒紫茎	raja
竹色溪下绿	tqix
竹深留客处	tiqt
竹石图	tdlt
朱淑真	rifh
朱淑贞	rihm
朱宿	ripw
朱孙	ribi
逐舞飘轻袖	ersp
竹溪村路板桥斜	tisw
朱晞颜	rjut
朱希真	rqfh
竹下忘言对紫茶	tgya
注想待元老	istf
竹香子	ttbb
朱休	riws
诸学士	yifg
珠压腰衱稳称身	gdet
主要参照了	yscb
竹叶坏水色	tkfq
铸以为金人十二	qnyf
竹影乱清风	tjtm
珠缨炫转星宿摇	gxor
朱雍	riyx
猪犹智慧胜愚曹	qqtg
珠玉买歌笑	ggnt
茱萸香	aatj
朱元夫	rffw
渚云低暗渡	ifwi
驻云飞	cfnu
拄杖落手心茫然	rsaq
竹枝	ttsf
贮之黄金屋	mpan
助之长者	eptf
竹枝子	tsbb
筑中置铅鱼隐刀	tklv
朱昼	riny
朱子厚	rbdj
诸子环洞庭而坐	ybgw
朱子奢	rbdf
朱子真	rbfh
转调二郎神	lyfp
转而攻秦	ldad
转教人忆春山	lfwm
转教小玉报双成	lfid
转觉鸬鹚毛色下	lihg
赚煞	muqv
转头向户里	lutj
转徙於江湖间	ltyu
转眼成人	lhdw
转应曲	lyma
转於僮仆亲	lywu
转轴拨弦三两声	llrf
妆罢低声问夫婿	ulwv
庄暴见孟子曰	yjmj
庄不得击	ygtf
妆成每被秋娘妒	udtv
妆成只是薰香坐	udkw
庄椿岁	ysmq
装点此关山	uhhm
壮观天下无	ucgf
壮丽江山	ugim
壮其蔚跂	uaak
壮士惨不骄	ufnc
壮士发冲冠	ufnp
壮岁失婵娟	umrv
壮心欲填海	unwi
庄以莅之	ynap
壮志逐年衰	ufey
庄周家贫	ympw
庄子持竿不顾	ybrd
庄子钓于濮水	ybqi
庄子妻死	ybgg
庄子送葬	ybua
庄子往见之	ybtp
追欢偶作	wcww
追凉	wnuy
追想吹箫处	wskt
惴惴小心	nnin
濯冠沐浴告祭酒	ipii
酌酒与君君自宽	sigp
啄木儿	ksqt
啄木曲	ksma
卓牌子	htbb
斫却月中桂	dfes
卓世清	haig
酌饮四座以散愁	sqlt
灼灼芙蓉姿	ooau
灼灼花	ooaw
自爱名山入剡中	teqk
自本自根	tsts
自彼则不见	ttmm
自伯之东	twpa
子不我即	bgtv
子不我思	bgtl
自惭居处崇	tnnm
子产听郑国之政	bukg
缁尘京国	xiyl
自称臣是酒中仙	ttaw
自此以往	thnt
自从春草长	twdt
自从建安来	twvg
资从岂待周	uwmm
自从弃置便衰朽	twys
自从双鬓斑斑白	twcr
自从献宝朝河宗	twfp
自大夫出	tdfb
自断此生休问天	tohg
自尔为佳节	tqya
自而治天下	tdig
自伐者无功	twfa
紫凤放娇衔楚佩	hmyw
自夫子之死也	tfbb
子告之曰	btpj
自歌自舞	tstr
自公多暇延参佐	twqw
子贡方人	bayw
自公退食	twvw
子贡问君子	baub
子贡问为仁	bauw
子贡问友	baud
子贡问政	baug
子固非鱼也	bldb
自古皆有死	tdxg
自古谁不死	tdyg
自顾无长策	tdft
自古以固存	tdnd
自挂东南枝	tras
自贵而相贱	tkdm
子规啼月小楼西	bfks
子罕第九	bptv
子罕言利	bpyt
紫毫笔	hytt
自河南经乱	tift
自恨寻芳到已迟	tnvn
紫花儿序	haqy
子华使于齐	bwwy
子惠思我	bglt
子击磬于卫	bffb
子几死乎	bmgt
自嫁黔娄百事乖	tvlt
子见夫子乎	bmft
子见南子	bmfb
子见齐衰者	bmyf
自见者不明	tmfj
梓匠轮舆	salw
子将奚先	buet
自解	thqe
自今及古	twed
自矜者不长	tcft
自经于沟渎	txgi
自觉谏书稀	tiyt
自君别我后	tvkr
自君之出矣	tvpc
自可	thsk
自可断来信	tsow
子兰	bbuf
字立之	pupp
自怜碧玉亲教舞	tngr
自怜春色罢	tndl
紫骝马	hccn
子路不对	bkgc
子路从而后	bkwr
子路第十三	bktd
子路拱而立	bkru
子路仁乎	bkwt
子路宿于石门	bkpu
子路问成人	bkuw
子路问君子	bkub
子路问事君	bkuv
子路问曰	bkuj
子路问政	bkug
子路无宿诺	bkfy
子路行以告	bktt
子路有闻	bkdu
姊妹弟兄皆列士	vvuf
姊妹弟兄皆列土	vvuf
自名秦罗敷	tqdg
自名为鸳鸯	tqym
自牧归荑	ttja
自南自北	tftu
子宁不来	bpgg
子宁不嗣音	bpgu
自其同者视之	tamp
自其异者视之	tanp
子禽问于子贡曰	bwuj
紫泉宫殿锁烟霞	hrpf
自然而得	tqdt
子如不言	bvgy
子入太庙	btdy
自三代以下者	tdwf
子生三年	btdr
子弑其父者有之	bqap
自是者不彰	tjfu
子帅以正	bjng
子所雅言	bray
紫藤	hxae
紫藤挂云木	hars
紫藤树	hasc
紫驼之峰出翠釜	hcpw
子谓伯鱼曰	bywj
子为恭也	byab
子谓公冶长	bywt
紫薇花	haaw
自谓经过旧不迷	tyxo
子未可以去乎	bfst
子谓南容	byfp
子谓冉有曰	bymj
子谓颜渊曰	byuj
子畏于匡	blga
子谓子产	bybu
子谓子贡曰	bybj
子谓子贱	bybm
子谓子夏曰	bybj
子温而厉	bidd
子闻之曰	bupj
自我不见	ttgm
自我徂尔	tttq
自我观之	ttcp
自我来黄州	ttgy
子无良媒	bfyv
自喜	thfk
子奚不为政	begg
自西自东	tsta
子兮子兮	bwbw
子夏问孝	bduf
子夏问曰	bduj
子夏云何	bdfw
自小不相识	tigy
自小阙内训	tiuy
自信人生二百年	twwr
子行三军	btdp
自行束修以上	ttgh
紫袖红弦明月中	hpxk
自许高材老更刚	tyym
自言本是京城女	tysv
紫阳花	hbaw
子夜	bbyw
子夜四时歌	byls
子夜吴歌	byks
子夜吴歌秋歌	byks
缁衣	xvye
子亦来见我乎	bygt
自遗其咎	tkat
子以四教	bnlf
自以为得	tnyt
自以为关中之固	tnyl
自咏	thky
子游对曰	bicj
兹游奇绝冠平生	uidt
自有岁寒心	tdmn
子游为武城宰	biyp
子游问孝	biuf
自有夜珠来	tdyg
子欲居九夷	bwng
自与清波闲	tgiu
子与人歌而善	bgwu
子于是日哭	bgjk
自喻适志与	tktg
紫玉箫	hgtv
字余曰灵均	pwjf
子曰何其	bjwa
自云良家子	tfyb
子在陈曰	bdbj
子在川上曰	bdkj
子在齐闻韶	bdyu
自贼者也	tmfb
子张第十九	bxtv
子张书诸绅	bxnx
子张问仁于孔子	bxub
子张问行	bxut
子张问曰	bxuj
子张问政	bxug
子张学干禄	bxip
子之不淑	bpgi
子之不知鱼之乐	bpgq
子之清扬	bpir
子之所慎	bprn
子之汤兮	bpiw
子治天下	bigg
子之武城	bpgf
子之燕居	bpan
子之迂也	bpgb
自知则知之	ttmp
子之知道	bptu
子知之乎	btpt
字字锦	ppqr
字字双	ppcc
字子瞻	pbhq
自足荡心耳	tkab
总不能避免	ugcq
宗臣遗像肃清高	paky
宗楚客	pspt
总此十思	uhfl
纵横计不就	xsyy
总角之宴	uqpp
纵浪大化中	xidk
纵令然诺暂相许	xwqy
宗庙会同	pywm
宗庙之事	pypg
纵然一夜风吹去	xqgf
纵使长条似旧垂	xwtt
纵使君来岂堪折	xwvr
纵使有花兼有月	xwde
纵死侠骨香	xgwt
纵死犹闻侠骨香	xgqt
总为浮云能蔽日	uyij
纵一苇之所如	xgav
纵有健妇把锄犁	xdwt
纵有笙歌亦断肠	xdte
宗之潇洒美少年	ppir
奏赋入明光	dmti
走马还寻去岁村	fcgs
走马红阳城	fcxf
走马兰台类转蓬	fcua
走马去如云	fcff
走马西来欲到天	fcsg
邹人与楚人战	qwgh
鲰生说我曰	qtyj
邹应龙	qydx
驺虞	cqha
邹与鲁哄	qgqk
俎豆之事	wgpg
足疾	khut
足茧荒山转愁疾	kaau
卒就死耳	yygb
祖可	pysk
祖母无臣	pxfa
族庖月更刀	yyev
租税从何出	ttwb
足下蹑丝履	kgkn
足以荣汝身	knat
足以息肩	knty
祖咏	pyky
足之所履	kprn
钻燧改火	qono
醉别江楼橘柚香	skit
醉不成欢惨将别	sgdk
醉春风	sdmq
醉春台	sdck
醉东风	samq
醉扶归	srjv
最高春	jydw
最高楼	jyso
醉公子	swbb
醉归扶路人应笑	sjrt
醉归应犯夜	sjyy
醉和金甲舞	stqr
醉红妆	sxuv
醉后	sgrg
醉后凉风起	sruf
醉花春	sadw
醉花番	sato
醉花间	sauj
醉花荫	saab
醉江月	siee
醉来脱宝剑	sgew
醉里得真如	sjtv
醉里时时错问君	sjjv
醉落魄	sarr
醉梅花	ssaw
醉眠秋共被	shtp
醉蓬莱	saag
醉起步溪月	sfhe
醉杀洞庭秋	sqit
最是楚宫俱泯灭	jjsg
最是繁丝摇落后	jjtr
醉时勇	sjce
醉思凡	slmy
醉思仙	slwm
醉太平	sdgu
醉桃园	sslf
醉桃源	ssid
醉翁操	swrk
醉卧不知白日暮	saga
最下腐刑极矣	jgyc
醉乡春	sxdw
醉行	sgtf
醉瑶瑟	sggg
醉吟	sgkw
醉游平泉	sigr
醉月频中圣	sehc
罪在朕躬	ldet
醉则从他醉	smws
醉折花枝当酒筹	srat
醉中天	skgd
醉妆词	suyn
遵大路	udkh
遵大路兮	udkw
樽酒家贫只旧醅	sips
樽酒慰离颜	sinu
尊其瞻视	uahp
尊亲之至	uupg
遵事迹犹遽	ugyh
尊贤而重士	ujdf
尊主强国之人	uyxw
昨别今已春	jkwd
坐愁红颜老	wtxf
坐地日行八万里	wfjj
坐对真成被花恼	wcfn
作赋凌相如	wmuv
坐忽枉故人诗	wqsy
作计何不量	wywj
作计乃尔立	wyeu
坐见落花长叹息	wmat
坐久落花多	wqaq
坐觉长安空	witp
坐看红树不知远	wrxf
座客	ywpt
坐客三千人	wpdw
座客三千人	ypdw
坐谋资庙略	wyul
左丘明耻之	drjp
昨日登高罢	jjwl
昨日看花花灼灼	jjro
坐伤时节阑	wwju
坐使青灯晓	wwgj
作师说以贻之	wjyp
左手低	drwq
作为此诗	wyhy
坐我潇湘洞庭	wtiy
左相日兴费万钱	dsjq
作性不能无	wngf
左旋右抽	dydr
左偃	dawa
作燕歌行以示适	wast
昨夜东风吹血腥	jyae
昨夜斗回北	jyuu
昨夜风开露井桃	jyms
昨夜秋风入汉关	jytu
昨夜裙带解	jypq
昨夜三更	jydg
昨夜上皇新授箓	jyht
昨夜谁为吴会吟	jyyk
昨夜微霜初度河	jyti
昨夜月同行	jyet
坐也坐不定	wbwp
作一词	wgyn
左右皆曰贤	ddxj
左右种梧桐	ddts
左誉	daiw
昨与故人期	jgda
作者七人矣	wfac
昨者州前槌大鼓	jfyf
左执簧	drta
座中泣下谁最多	ykiq
座中醉客延醒客	yksp